"fips","Trump","Biden","Other","TotCounty","CountyName","State","VotingPref"
1001,19838,7503,429,27770,"AUTAUGA","AL","Red"
1003,83544,24578,1557,109679,"BALDWIN","AL","Red"
1005,5622,4816,80,10518,"BARBOUR","AL","Red"
1007,7525,1986,84,9595,"BIBB","AL","Red"
1009,24711,2640,237,27588,"BLOUNT","AL","Red"
1011,1146,3446,21,4613,"BULLOCK","AL","Blue"
1013,5458,3965,65,9488,"BUTLER","AL","Red"
1015,35101,15216,666,50983,"CALHOUN","AL","Red"
1017,8753,6365,166,15284,"CHAMBERS","AL","Red"
1019,10583,1624,94,12301,"CHEROKEE","AL","Red"
1021,16085,3073,152,19310,"CHILTON","AL","Red"
1023,4296,3127,41,7464,"CHOCTAW","AL","Red"
1025,7324,5755,56,13135,"CLARKE","AL","Red"
1027,5601,1267,62,6930,"CLAY","AL","Red"
1029,6484,675,68,7227,"CLEBURNE","AL","Red"
1031,16899,5076,300,22275,"COFFEE","AL","Red"
1033,19203,8343,340,27886,"COLBERT","AL","Red"
1035,3442,2966,33,6441,"CONECUH","AL","Red"
1037,3631,1796,52,5479,"COOSA","AL","Red"
1039,14586,2721,123,17430,"COVINGTON","AL","Red"
1041,4864,1700,53,6617,"CRENSHAW","AL","Red"
1043,36880,4478,493,41851,"CULLMAN","AL","Red"
1045,14303,5170,265,19738,"DALE","AL","Red"
1047,5524,12230,110,17864,"DALLAS","AL","Blue"
1049,24767,4281,308,29356,"DEKALB","AL","Red"
1051,30164,10367,499,41030,"ELMORE","AL","Red"
1053,10869,4918,123,15910,"ESCAMBIA","AL","Red"
1055,35528,11567,633,47728,"ETOWAH","AL","Red"
1057,7300,1395,71,8766,"FAYETTE","AL","Red"
1059,10376,2086,116,12578,"FRANKLIN","AL","Red"
1061,10848,1595,102,12545,"GENEVA","AL","Red"
1063,875,3884,16,4775,"GREENE","AL","Blue"
1065,3192,4663,45,7900,"HALE","AL","Blue"
1067,6607,2606,85,9298,"HENRY","AL","Red"
1069,32618,12917,638,46173,"HOUSTON","AL","Red"
1071,19670,3717,249,23636,"JACKSON","AL","Red"
1073,138843,181688,5317,325848,"JEFFERSON","AL","Blue"
1075,6174,978,41,7193,"LAMAR","AL","Red"
1077,31721,11915,703,44339,"LAUDERDALE","AL","Red"
1079,12322,3562,147,16031,"LAWRENCE","AL","Red"
1081,42221,27860,1368,71449,"LEE","AL","Red"
1083,34640,13672,923,49235,"LIMESTONE","AL","Red"
1085,1836,4972,27,6835,"LOWNDES","AL","Blue"
1087,1541,7108,74,8723,"MACON","AL","Blue"
1089,102780,87286,4701,194767,"MADISON","AL","Red"
1091,5343,5488,69,10900,"MARENGO","AL","Blue"
1093,12205,1463,139,13807,"MARION","AL","Red"
1095,33191,5943,521,39655,"MARSHALL","AL","Red"
1097,101243,79474,2447,183164,"MOBILE","AL","Red"
1099,6147,4455,66,10668,"MONROE","AL","Red"
1101,33311,64529,1299,99139,"MONTGOMERY","AL","Blue"
1103,39664,13234,824,53722,"MORGAN","AL","Red"
1105,1339,3860,31,5230,"PERRY","AL","Blue"
1107,5594,4022,52,9668,"PICKENS","AL","Red"
1109,8042,5636,163,13841,"PIKE","AL","Red"
1111,8559,2203,75,10837,"RANDOLPH","AL","Red"
1113,9864,11228,237,21329,"RUSSELL","AL","Blue"
1115,36166,7744,531,44441,"ST. CLAIR","AL","Red"
1117,79700,33268,1982,114950,"SHELBY","AL","Red"
1119,1598,4648,45,6291,"SUMTER","AL","Blue"
1121,22235,13138,290,35663,"TALLADEGA","AL","Red"
1123,14963,5859,169,20991,"TALLAPOOSA","AL","Red"
1125,51117,37765,1290,90172,"TUSCALOOSA","AL","Red"
1127,26002,4834,334,31170,"WALKER","AL","Red"
1129,6564,2258,54,8876,"WASHINGTON","AL","Red"
1131,1833,4048,22,5903,"WILCOX","AL","Blue"
1133,10195,974,115,11284,"WINSTON","AL","Red"
2001,3511,3477,326,7314,"DISTRICT 1","AK","Red"
2002,3674,2104,358,6136,"DISTRICT 2","AK","Red"
2003,6076,1903,406,8385,"DISTRICT 3","AK","Red"
2004,4690,5345,476,10511,"DISTRICT 4","AK","Blue"
2005,4077,4204,373,8654,"DISTRICT 5","AK","Blue"
2006,5770,3272,418,9460,"DISTRICT 6","AK","Red"
2007,7027,2215,380,9622,"DISTRICT 7","AK","Red"
2008,7618,1953,341,9912,"DISTRICT 8","AK","Red"
2009,7787,2769,437,10993,"DISTRICT 9","AK","Red"
2010,8081,2727,397,11205,"DISTRICT 10","AK","Red"
2011,7096,3130,402,10628,"DISTRICT 11","AK","Red"
2012,7893,2957,388,11238,"DISTRICT 12","AK","Red"
2013,4652,2666,395,7713,"DISTRICT 13","AK","Red"
2014,6714,4261,468,11443,"DISTRICT 14","AK","Red"
2015,2671,2622,266,5559,"DISTRICT 15","AK","Red"
2016,3516,4274,328,8118,"DISTRICT 16","AK","Blue"
2017,2810,4136,293,7239,"DISTRICT 17","AK","Blue"
2018,2760,4681,279,7720,"DISTRICT 18","AK","Blue"
2019,1975,3118,208,5301,"DISTRICT 19","AK","Blue"
2020,2383,4881,233,7497,"DISTRICT 20","AK","Blue"
2021,3690,5414,325,9429,"DISTRICT 21","AK","Blue"
2022,4684,4553,283,9520,"DISTRICT 22","AK","Red"
2023,3655,3810,274,7739,"DISTRICT 23","AK","Blue"
2024,5378,4736,314,10428,"DISTRICT 24","AK","Red"
2025,4407,4600,318,9325,"DISTRICT 25","AK","Blue"
2026,5243,4558,310,10111,"DISTRICT 26","AK","Red"
2027,4324,4844,338,9506,"DISTRICT 27","AK","Blue"
2028,6162,6264,323,12749,"DISTRICT 28","AK","Blue"
2029,7464,2985,298,10747,"DISTRICT 29","AK","Red"
2030,7180,2638,358,10176,"DISTRICT 30","AK","Red"
2031,6971,5037,402,12410,"DISTRICT 31","AK","Red"
2032,4440,3506,389,8335,"DISTRICT 32","AK","Red"
2033,3059,7535,361,10955,"DISTRICT 33","AK","Blue"
2034,4543,5763,423,10729,"DISTRICT 34","AK","Blue"
2035,4769,5011,322,10102,"DISTRICT 35","AK","Blue"
2036,5114,3796,382,9292,"DISTRICT 36","AK","Red"
2037,2358,2560,224,5142,"DISTRICT 37","AK","Blue"
2038,1737,3202,360,5299,"DISTRICT 38","AK","Blue"
2039,1939,3580,372,5891,"DISTRICT 39","AK","Blue"
2040,1994,2318,291,4603,"DISTRICT 40","AK","Blue"
2099,59,373,1,433,"DISTRICT 99","AK","Blue"
4001,11442,23293,437,35172,"APACHE","AZ","Blue"
4003,35557,23732,1153,60442,"COCHISE","AZ","Red"
4005,27052,44698,1522,73272,"COCONINO","AZ","Blue"
4007,18377,8943,342,27662,"GILA","AZ","Red"
4009,10749,4034,212,14995,"GRAHAM","AZ","Red"
4011,2433,1182,70,3685,"GREENLEE","AZ","Red"
4012,5129,2236,93,7458,"LA PAZ","AZ","Red"
4013,995665,1040774,31705,2068144,"MARICOPA","AZ","Blue"
4015,78535,24831,1302,104668,"MOHAVE","AZ","Red"
4017,27657,23383,727,51767,"NAVAJO","AZ","Red"
4019,207758,304981,7658,520397,"PIMA","AZ","Blue"
4021,107077,75106,2791,184974,"PINAL","AZ","Red"
4023,6194,13138,224,19556,"SANTA CRUZ","AZ","Blue"
4025,91527,49602,2092,143221,"YAVAPAI","AZ","Red"
4027,36534,32210,1137,69881,"YUMA","AZ","Red"
5001,4304,1818,170,6292,"ARKANSAS","AR","Red"
5003,5548,2125,253,7926,"ASHLEY","AR","Red"
5005,15836,4635,536,21007,"BAXTER","AR","Red"
5007,73965,42249,3698,119912,"BENTON","AR","Red"
5009,13652,3064,398,17114,"BOONE","AR","Red"
5011,2335,1214,105,3654,"BRADLEY","AR","Red"
5013,1636,479,67,2182,"CALHOUN","AR","Red"
5015,7424,4023,350,11797,"CARROLL","AR","Red"
5017,1752,2260,91,4103,"CHICOT","AR","Blue"
5019,4616,3438,341,8395,"CLARK","AR","Red"
5021,4086,962,135,5183,"CLAY","AR","Red"
5023,10328,1988,364,12680,"CLEBURNE","AR","Red"
5025,2867,651,82,3600,"CLEVELAND","AR","Red"
5027,5500,2814,302,8616,"COLUMBIA","AR","Red"
5029,5694,2615,376,8685,"CONWAY","AR","Red"
5031,25558,11921,1032,38511,"CRAIGHEAD","AR","Red"
5033,18607,4959,525,24091,"CRAWFORD","AR","Red"
5035,7333,8514,520,16367,"CRITTENDEN","AR","Blue"
5037,4946,1772,224,6942,"CROSS","AR","Red"
5039,1573,963,113,2649,"DALLAS","AR","Red"
5041,1921,2016,227,4164,"DESHA","AR","Blue"
5043,4349,2426,133,6908,"DREW","AR","Red"
5045,34421,18347,1660,54428,"FAULKNER","AR","Red"
5047,5677,1300,152,7129,"FRANKLIN","AR","Red"
5049,3961,1035,123,5119,"FULTON","AR","Red"
5051,29069,14045,1085,44199,"GARLAND","AR","Red"
5053,6794,1268,138,8200,"GRANT","AR","Red"
5055,12670,3058,372,16100,"GREENE","AR","Red"
5057,4470,2138,240,6848,"HEMPSTEAD","AR","Red"
5059,9202,3082,273,12557,"HOT SPRING","AR","Red"
5061,3367,1340,127,4834,"HOWARD","AR","Red"
5063,11250,2806,456,14512,"INDEPENDENCE","AR","Red"
5065,4631,1021,158,5810,"IZARD","AR","Red"
5067,3593,1365,133,5091,"JACKSON","AR","Red"
5069,9521,14981,656,25158,"JEFFERSON","AR","Blue"
5071,6938,2283,277,9498,"JOHNSON","AR","Red"
5073,1757,839,83,2679,"LAFAYETTE","AR","Red"
5075,4569,1080,208,5857,"LAWRENCE","AR","Red"
5077,1286,1423,139,2848,"LEE","AR","Blue"
5079,2729,1032,114,3875,"LINCOLN","AR","Red"
5081,3715,1226,236,5177,"LITTLE RIVER","AR","Red"
5083,6441,1544,240,8225,"LOGAN","AR","Red"
5085,22884,6686,1092,30662,"LONOKE","AR","Red"
5087,5658,1563,130,7351,"MADISON","AR","Red"
5089,5783,1531,189,7503,"MARION","AR","Red"
5091,11920,4245,364,16529,"MILLER","AR","Red"
5093,7296,4558,488,12342,"MISSISSIPPI","AR","Red"
5095,1545,1147,124,2816,"MONROE","AR","Red"
5097,3046,731,96,3873,"MONTGOMERY","AR","Red"
5099,2133,1076,149,3358,"NEVADA","AR","Red"
5101,3192,709,97,3998,"NEWTON","AR","Red"
5103,5294,3995,340,9629,"OUACHITA","AR","Red"
5105,3479,1012,136,4627,"PERRY","AR","Red"
5107,2417,3623,202,6242,"PHILLIPS","AR","Blue"
5109,3519,644,83,4246,"PIKE","AR","Red"
5111,5918,1424,179,7521,"POINSETT","AR","Red"
5113,7035,1246,209,8490,"POLK","AR","Red"
5115,18081,5772,579,24432,"POPE","AR","Red"
5117,2786,654,55,3495,"PRAIRIE","AR","Red"
5119,63687,101947,4322,169956,"PULASKI","AR","Blue"
5121,5355,1215,242,6812,"RANDOLPH","AR","Red"
5123,3242,3604,262,7108,"ST. FRANCIS","AR","Blue"
5125,39556,16060,1343,56959,"SALINE","AR","Red"
5127,2962,483,106,3551,"SCOTT","AR","Red"
5129,3365,588,66,4019,"SEARCY","AR","Red"
5131,31198,14487,1455,47140,"SEBASTIAN","AR","Red"
5133,3884,1116,202,5202,"SEVIER","AR","Red"
5135,5938,1398,230,7566,"SHARP","AR","Red"
5137,4616,1180,142,5938,"STONE","AR","Red"
5139,10478,5584,545,16607,"UNION","AR","Red"
5141,6034,1593,180,7807,"VAN BUREN","AR","Red"
5143,47504,43824,2938,94266,"WASHINGTON","AR","Red"
5145,24182,5978,725,30885,"WHITE","AR","Red"
5147,1543,856,77,2476,"WOODRUFF","AR","Red"
5149,5226,1284,231,6741,"YELL","AR","Red"
6001,136309,617659,16102,770070,"ALAMEDA","CA","Blue"
6003,244,476,21,741,"ALPINE","CA","Blue"
6005,13585,8153,566,22304,"AMADOR","CA","Red"
6007,48730,50426,2910,102066,"BUTTE","CA","Blue"
6009,16518,10046,600,27164,"CALAVERAS","CA","Red"
6011,4559,3239,163,7961,"COLUSA","CA","Red"
6013,152877,416386,12053,581316,"CONTRA COSTA","CA","Blue"
6015,6461,4677,315,11453,"DEL NORTE","CA","Red"
6017,61838,51621,2700,116159,"EL DORADO","CA","Red"
6019,164464,193025,7428,364917,"FRESNO","CA","Blue"
6021,7063,3995,239,11297,"GLENN","CA","Red"
6023,21770,44768,2305,68843,"HUMBOLDT","CA","Blue"
6025,20847,34678,1218,56743,"IMPERIAL","CA","Blue"
6027,4620,4634,230,9484,"INYO","CA","Blue"
6029,164484,133366,7442,305292,"KERN","CA","Red"
6031,24072,18699,1090,43861,"KINGS","CA","Red"
6033,13123,14941,748,28812,"LAKE","CA","Blue"
6035,8970,2799,218,11987,"LASSEN","CA","Red"
6037,1145530,3028885,89950,4264365,"LOS ANGELES","CA","Blue"
6039,29378,23168,1186,53732,"MADERA","CA","Red"
6041,24612,128288,2930,155830,"MARIN","CA","Blue"
6043,5950,4088,242,10280,"MARIPOSA","CA","Red"
6045,13267,28782,1291,43340,"MENDOCINO","CA","Blue"
6047,39397,48991,2166,90554,"MERCED","CA","Blue"
6049,3109,1150,84,4343,"MODOC","CA","Red"
6051,2513,4013,212,6738,"MONO","CA","Blue"
6053,46299,113953,3671,163923,"MONTEREY","CA","Blue"
6055,20676,49817,1657,72150,"NAPA","CA","Blue"
6057,26779,36359,1612,64750,"NEVADA","CA","Blue"
6059,676498,814009,31606,1522113,"ORANGE","CA","Blue"
6061,122488,106869,5727,235084,"PLACER","CA","Red"
6063,6445,4561,254,11260,"PLUMAS","CA","Red"
6065,449144,528340,19672,997156,"RIVERSIDE","CA","Blue"
6067,259405,440808,18227,718440,"SACRAMENTO","CA","Blue"
6069,10590,17628,612,28830,"SAN BENITO","CA","Blue"
6071,366257,455859,19014,841130,"SAN BERNARDINO","CA","Blue"
6073,600094,964650,37399,1602143,"SAN DIEGO","CA","Blue"
6075,56417,378156,8980,443553,"SAN FRANCISCO","CA","Blue"
6077,121098,161137,3993,286228,"SAN JOAQUIN","CA","Blue"
6079,67436,88310,3968,159714,"SAN LUIS OBISPO","CA","Blue"
6081,75584,291496,7171,374251,"SAN MATEO","CA","Blue"
6083,65736,129963,4640,200339,"SANTA BARBARA","CA","Blue"
6085,214612,617967,18162,850741,"SANTA CLARA","CA","Blue"
6087,26937,114246,3654,144837,"SANTA CRUZ","CA","Blue"
6089,60789,30000,2141,92930,"SHASTA","CA","Red"
6091,1142,730,59,1931,"SIERRA","CA","Red"
6093,13290,9593,589,23472,"SISKIYOU","CA","Red"
6095,69306,131639,4932,205877,"SOLANO","CA","Blue"
6097,61825,199938,6554,268317,"SONOMA","CA","Blue"
6099,104145,105841,4968,214954,"STANISLAUS","CA","Blue"
6101,24375,17367,902,42644,"SUTTER","CA","Red"
6103,19141,8911,679,28731,"TEHAMA","CA","Red"
6105,3188,2851,220,6259,"TRINITY","CA","Red"
6107,77579,66105,3201,146885,"TULARE","CA","Red"
6109,17689,11978,741,30408,"TUOLUMNE","CA","Red"
6111,162207,251388,9230,422825,"VENTURA","CA","Blue"
6113,27292,67598,2404,97294,"YOLO","CA","Blue"
6115,17676,11230,890,29796,"YUBA","CA","Red"
8001,95657,134202,6881,236740,"ADAMS","CO","Blue"
8003,3813,3759,236,7808,"ALAMOSA","CO","Red"
8005,127323,213607,9253,350183,"ARAPAHOE","CO","Blue"
8007,5189,3738,217,9144,"ARCHULETA","CO","Red"
8009,1867,317,41,2225,"BACA","CO","Red"
8011,1503,732,39,2274,"BENT","CO","Red"
8013,42501,159089,4521,206111,"BOULDER","CO","Blue"
8014,16295,29077,1260,46632,"BROOMFIELD","CO","Blue"
8015,6222,7160,336,13718,"CHAFFEE","CO","Blue"
8017,993,131,12,1136,"CHEYENNE","CO","Red"
8019,2754,3604,190,6548,"CLEAR CREEK","CO","Blue"
8021,2286,1959,88,4333,"CONEJOS","CO","Red"
8023,741,1311,42,2094,"COSTILLA","CO","Blue"
8025,1271,437,42,1750,"CROWLEY","CO","Red"
8027,2474,1112,49,3635,"CUSTER","CO","Red"
8029,13081,5887,402,19370,"DELTA","CO","Red"
8031,71618,313293,8918,393829,"DENVER","CO","Blue"
8033,1089,341,19,1449,"DOLORES","CO","Red"
8035,121270,104653,5682,231605,"DOUGLAS","CO","Red"
8037,9892,18588,660,29140,"EAGLE","CO","Blue"
8039,14027,4490,466,18983,"ELBERT","CO","Red"
8041,202828,161941,14082,378851,"EL PASO","CO","Red"
8043,17517,7369,671,25557,"FREMONT","CO","Red"
8045,14717,15427,760,30904,"GARFIELD","CO","Blue"
8047,1833,2223,130,4186,"GILPIN","CO","Blue"
8049,4883,4710,277,9870,"GRAND","CO","Red"
8051,3735,7132,323,11190,"GUNNISON","CO","Blue"
8053,353,255,24,632,"HINSDALE","CO","Red"
8055,2203,2076,127,4406,"HUERFANO","CO","Red"
8057,681,175,20,876,"JACKSON","CO","Red"
8059,148417,218396,10545,377358,"JEFFERSON","CO","Blue"
8061,795,98,10,903,"KIOWA","CO","Red"
8063,3144,662,65,3871,"KIT CARSON","CO","Red"
8065,1497,2303,161,3961,"LAKE","CO","Blue"
8067,14233,20548,886,35667,"LA PLATA","CO","Blue"
8069,91489,126120,6729,224338,"LARIMER","CO","Blue"
8071,4284,3497,180,7961,"LAS ANIMAS","CO","Red"
8073,2135,470,46,2651,"LINCOLN","CO","Red"
8075,8087,2218,227,10532,"LOGAN","CO","Red"
8077,56894,31536,2193,90623,"MESA","CO","Red"
8079,427,317,12,756,"MINERAL","CO","Red"
8081,5670,1203,153,7026,"MOFFAT","CO","Red"
8083,9306,5836,358,15500,"MONTEZUMA","CO","Red"
8085,16770,7687,465,24922,"MONTROSE","CO","Red"
8087,9593,3876,275,13744,"MORGAN","CO","Red"
8089,5756,3605,215,9576,"OTERO","CO","Red"
8091,1577,2365,78,4020,"OURAY","CO","Blue"
8093,6991,4903,397,12291,"PARK","CO","Red"
8095,1958,486,41,2485,"PHILLIPS","CO","Red"
8097,2780,8989,188,11957,"PITKIN","CO","Blue"
8099,4008,1458,95,5561,"PROWERS","CO","Red"
8101,42252,43772,2277,88301,"PUEBLO","CO","Blue"
8103,3061,561,69,3691,"RIO BLANCO","CO","Red"
8105,3660,2495,150,6305,"RIO GRANDE","CO","Red"
8107,5925,10582,369,16876,"ROUTT","CO","Blue"
8109,1413,1884,92,3389,"SAGUACHE","CO","Blue"
8111,202,342,18,562,"SAN JUAN","CO","Blue"
8113,1136,3924,87,5147,"SAN MIGUEL","CO","Blue"
8115,1121,301,24,1446,"SEDGWICK","CO","Red"
8117,5322,12631,526,18479,"SUMMIT","CO","Blue"
8119,11241,5278,420,16939,"TELLER","CO","Red"
8121,2595,369,44,3008,"WASHINGTON","CO","Red"
8123,96145,66060,4769,166974,"WELD","CO","Red"
8125,4107,785,89,4981,"YUMA","CO","Red"
9001,168445,297505,6446,472396,"FAIRFIELD","CT","Blue"
9003,159024,283368,6944,449336,"HARTFORD","CT","Blue"
9005,55601,50164,1779,107544,"LITCHFIELD","CT","Red"
9007,40665,56848,1685,99198,"MIDDLESEX","CT","Blue"
9009,169893,242630,5460,417983,"NEW HAVEN","CT","Blue"
9011,57110,79459,3035,139604,"NEW LONDON","CT","Blue"
9013,34838,44151,1725,80714,"TOLLAND","CT","Blue"
9015,29141,26706,1235,57082,"WINDHAM","CT","Red"
10001,41009,44552,1464,87025,"KENT","DE","Blue"
10003,88364,195034,4235,287633,"NEW CASTLE","DE","Blue"
10005,71230,56682,1440,129352,"SUSSEX","DE","Red"
11001,18586,317323,8447,344356,"DISTRICT OF COLUMBIA","DC","Blue"
12001,50972,89704,1928,142604,"ALACHUA","FL","Blue"
12003,11911,2037,111,14059,"BAKER","FL","Red"
12005,66097,25614,1313,93024,"BAY","FL","Red"
12007,10334,3160,138,13632,"BRADFORD","FL","Red"
12009,207883,148549,4332,360764,"BREVARD","FL","Red"
12011,333409,618752,5511,957672,"BROWARD","FL","Blue"
12013,5274,1209,43,6526,"CALHOUN","FL","Red"
12015,73243,42273,824,116340,"CHARLOTTE","FL","Red"
12017,65352,27092,764,93208,"CITRUS","FL","Red"
12019,84480,38317,1608,124405,"CLAY","FL","Red"
12021,128950,77621,1247,207818,"COLLIER","FL","Red"
12023,23836,8914,292,33042,"COLUMBIA","FL","Red"
12027,8313,4259,87,12659,"DESOTO","FL","Red"
12029,6759,1365,43,8167,"DIXIE","FL","Red"
12031,233762,252556,6502,492820,"DUVAL","FL","Blue"
12033,96674,70929,2769,170372,"ESCAMBIA","FL","Red"
12035,43043,28161,512,71716,"FLAGLER","FL","Red"
12037,4675,2120,54,6849,"FRANKLIN","FL","Red"
12039,7465,16153,144,23762,"GADSDEN","FL","Blue"
12041,7895,1700,90,9685,"GILCHRIST","FL","Red"
12043,3782,1385,26,5193,"GLADES","FL","Red"
12045,6113,1985,65,8163,"GULF","FL","Red"
12047,3815,1963,52,5830,"HAMILTON","FL","Red"
12049,6122,2298,65,8485,"HARDEE","FL","Red"
12051,7906,4929,105,12940,"HENDRY","FL","Red"
12053,70412,37519,991,108922,"HERNANDO","FL","Red"
12055,34873,16938,359,52170,"HIGHLANDS","FL","Red"
12057,327398,376367,8298,712063,"HILLSBOROUGH","FL","Blue"
12059,8080,924,64,9068,"HOLMES","FL","Red"
12061,58872,37844,768,97484,"INDIAN RIVER","FL","Red"
12063,15488,6766,165,22419,"JACKSON","FL","Red"
12065,4479,3897,75,8451,"JEFFERSON","FL","Red"
12067,3128,510,20,3658,"LAFAYETTE","FL","Red"
12069,125859,83505,1950,211314,"LAKE","FL","Red"
12071,233247,157695,2957,393899,"LEE","FL","Red"
12073,57453,103517,1959,162929,"LEON","FL","Blue"
12075,16749,6205,191,23145,"LEVY","FL","Red"
12077,2846,694,21,3561,"LIBERTY","FL","Red"
12079,5576,3747,57,9380,"MADISON","FL","Red"
12081,124987,90166,1805,216958,"MANATEE","FL","Red"
12083,127826,74858,1692,204376,"MARION","FL","Red"
12085,61168,36893,665,98726,"MARTIN","FL","Red"
12086,532833,617864,6119,1156816,"MIAMI-DADE","FL","Blue"
12087,25693,21881,455,48029,"MONROE","FL","Red"
12089,42566,15564,681,58811,"NASSAU","FL","Red"
12091,79798,34248,2327,116373,"OKALOOSA","FL","Red"
12093,11470,4390,94,15954,"OKEECHOBEE","FL","Red"
12095,245398,395014,6991,647403,"ORANGE","FL","Blue"
12097,73480,97297,1659,172436,"OSCEOLA","FL","Blue"
12099,334711,433572,4875,773158,"PALM BEACH","FL","Blue"
12101,179621,119073,3276,301970,"PASCO","FL","Red"
12103,276209,277450,6056,559715,"PINELLAS","FL","Blue"
12105,194586,145049,3621,343256,"POLK","FL","Red"
12107,25514,10527,332,36373,"PUTNAM","FL","Red"
12109,110946,63850,1826,176622,"ST. JOHNS","FL","Red"
12111,86831,84137,1201,172169,"ST. LUCIE","FL","Red"
12113,77385,27612,1931,106928,"SANTA ROSA","FL","Red"
12115,148370,120110,2095,270575,"SARASOTA","FL","Red"
12117,125241,132528,3046,260815,"SEMINOLE","FL","Blue"
12119,62761,29341,383,92485,"SUMTER","FL","Red"
12121,16410,4485,162,21057,"SUWANNEE","FL","Red"
12123,7751,2299,77,10127,"TAYLOR","FL","Red"
12125,5133,1053,59,6245,"UNION","FL","Red"
12127,173821,130575,3043,307439,"VOLUSIA","FL","Red"
12129,12874,5351,179,18404,"WAKULLA","FL","Red"
12131,32947,10338,426,43711,"WALTON","FL","Red"
12133,9876,2347,104,12327,"WASHINGTON","FL","Red"
13001,6526,1779,36,8341,"APPLING","GA","Red"
13003,2300,825,30,3155,"ATKINSON","GA","Red"
13005,4018,625,25,4668,"BACON","GA","Red"
13007,897,652,6,1555,"BAKER","GA","Red"
13009,8903,9140,208,18251,"BALDWIN","GA","Blue"
13011,7795,932,74,8801,"BANKS","GA","Red"
13013,26804,10453,664,37921,"BARROW","GA","Red"
13015,37674,12092,701,50467,"BARTOW","GA","Red"
13017,4110,2392,58,6560,"BEN HILL","GA","Red"
13019,6419,1269,55,7743,"BERRIEN","GA","Red"
13021,26585,43468,749,70802,"BIBB","GA","Blue"
13023,4328,1311,67,5706,"BLECKLEY","GA","Red"
13025,6991,699,56,7746,"BRANTLEY","GA","Red"
13027,4260,2790,50,7100,"BROOKS","GA","Red"
13029,14244,6739,357,21340,"BRYAN","GA","Red"
13031,18386,11243,455,30084,"BULLOCH","GA","Red"
13033,5400,5209,75,10684,"BURKE","GA","Red"
13035,8406,3274,91,11771,"BUTTS","GA","Red"
13037,923,1260,11,2194,"CALHOUN","GA","Blue"
13039,15251,7967,470,23688,"CAMDEN","GA","Red"
13043,3133,1269,29,4431,"CANDLER","GA","Red"
13045,37476,16238,760,54474,"CARROLL","GA","Red"
13047,25167,6932,494,32593,"CATOOSA","GA","Red"
13049,3419,1103,44,4566,"CHARLTON","GA","Red"
13051,53237,78254,1929,133420,"CHATHAM","GA","Blue"
13053,880,667,35,1582,"CHATTAHOOCHEE","GA","Red"
13055,8064,1854,132,10050,"CHATTOOGA","GA","Red"
13057,99587,42794,2449,144830,"CHEROKEE","GA","Red"
13059,14446,36048,839,51333,"CLARKE","GA","Blue"
13061,637,790,7,1434,"CLAY","GA","Blue"
13063,15813,95476,1055,112344,"CLAYTON","GA","Blue"
13065,2105,747,12,2864,"CLINCH","GA","Red"
13067,165459,221846,6441,393746,"COBB","GA","Blue"
13069,10578,4511,125,15214,"COFFEE","GA","Red"
13071,11777,4187,119,16083,"COLQUITT","GA","Red"
13073,50013,29236,1330,80579,"COLUMBIA","GA","Red"
13075,4900,2059,76,7035,"COOK","GA","Red"
13077,51501,24210,1088,76799,"COWETA","GA","Red"
13079,4428,1615,59,6102,"CRAWFORD","GA","Red"
13081,4987,2986,66,8039,"CRISP","GA","Red"
13083,6066,1261,107,7434,"DADE","GA","Red"
13085,13398,2486,197,16081,"DAWSON","GA","Red"
13087,6758,4780,89,11627,"DECATUR","GA","Red"
13089,58373,308227,4204,370804,"DEKALB","GA","Blue"
13091,5843,2171,56,8070,"DODGE","GA","Red"
13093,2159,1911,35,4105,"DOOLY","GA","Red"
13095,10454,24577,280,35311,"DOUGHERTY","GA","Blue"
13097,25451,42809,837,69097,"DOUGLAS","GA","Blue"
13099,2722,2437,28,5187,"EARLY","GA","Red"
13101,1256,167,18,1441,"ECHOLS","GA","Red"
13103,23358,7720,492,31570,"EFFINGHAM","GA","Red"
13105,6226,2879,66,9171,"ELBERT","GA","Red"
13107,6551,2884,66,9501,"EMANUEL","GA","Red"
13109,2888,1324,35,4247,"EVANS","GA","Red"
13111,12169,2571,110,14850,"FANNIN","GA","Red"
13113,37952,33065,976,71993,"FAYETTE","GA","Red"
13115,29123,12008,517,41648,"FLOYD","GA","Red"
13117,85122,42203,1980,129305,"FORSYTH","GA","Red"
13119,9069,1593,103,10765,"FRANKLIN","GA","Red"
13121,137240,381144,6275,524659,"FULTON","GA","Blue"
13123,13429,2932,164,16525,"GILMER","GA","Red"
13125,1403,155,8,1566,"GLASCOCK","GA","Red"
13127,25616,15879,489,41984,"GLYNN","GA","Red"
13129,19405,4384,244,24033,"GORDON","GA","Red"
13131,7034,3619,54,10707,"GRADY","GA","Red"
13133,7068,4088,91,11247,"GREENE","GA","Red"
13135,166413,241827,5625,413865,"GWINNETT","GA","Blue"
13137,16637,3563,232,20432,"HABERSHAM","GA","Red"
13139,64170,25031,1322,90523,"HALL","GA","Red"
13141,1159,2985,21,4165,"HANCOCK","GA","Blue"
13143,12331,1792,125,14248,"HARALSON","GA","Red"
13145,14319,5457,215,19991,"HARRIS","GA","Red"
13147,9464,3157,106,12727,"HART","GA","Red"
13149,4516,824,51,5391,"HEARD","GA","Red"
13151,48187,73276,1279,122742,"HENRY","GA","Blue"
13153,41534,32232,1057,74823,"HOUSTON","GA","Red"
13155,3134,1008,26,4168,"IRWIN","GA","Red"
13157,29497,7642,531,37670,"JACKSON","GA","Red"
13159,5822,1761,61,7644,"JASPER","GA","Red"
13161,4695,1028,48,5771,"JEFF DAVIS","GA","Red"
13163,3537,4061,44,7642,"JEFFERSON","GA","Blue"
13165,2161,1266,28,3455,"JENKINS","GA","Red"
13167,2850,1222,28,4100,"JOHNSON","GA","Red"
13169,9965,4888,113,14966,"JONES","GA","Red"
13171,6330,2615,94,9039,"LAMAR","GA","Red"
13173,2509,1019,48,3576,"LANIER","GA","Red"
13175,14493,8073,163,22729,"LAURENS","GA","Red"
13177,12007,4558,149,16714,"LEE","GA","Red"
13179,7959,13099,331,21389,"LIBERTY","GA","Blue"
13181,3179,1435,36,4650,"LINCOLN","GA","Red"
13183,3528,2033,95,5656,"LONG","GA","Red"
13185,25691,20117,547,46355,"LOWNDES","GA","Red"
13187,12163,3126,242,15531,"LUMPKIN","GA","Red"
13189,6169,4168,118,10455,"MCDUFFIE","GA","Red"
13191,4016,2612,68,6696,"MCINTOSH","GA","Red"
13193,1783,2857,22,4662,"MACON","GA","Blue"
13195,11326,3411,200,14937,"MADISON","GA","Red"
13197,2275,1311,38,3624,"MARION","GA","Red"
13199,6524,4287,66,10877,"MERIWETHER","GA","Red"
13201,2066,749,20,2835,"MILLER","GA","Red"
13205,4935,3995,33,8963,"MITCHELL","GA","Red"
13207,11060,4384,148,15592,"MONROE","GA","Red"
13209,2960,979,27,3966,"MONTGOMERY","GA","Red"
13211,8230,3355,122,11707,"MORGAN","GA","Red"
13213,12943,2302,144,15389,"MURRAY","GA","Red"
13215,30049,49529,965,80543,"MUSCOGEE","GA","Blue"
13217,23869,29794,576,54239,"NEWTON","GA","Blue"
13219,16595,8162,411,25168,"OCONEE","GA","Red"
13221,5593,2436,102,8131,"OGLETHORPE","GA","Red"
13223,54525,29704,1156,85385,"PAULDING","GA","Red"
13225,6502,5920,123,12545,"PEACH","GA","Red"
13227,14075,2808,233,17116,"PICKENS","GA","Red"
13229,7899,1100,49,9048,"PIERCE","GA","Red"
13231,9127,1505,88,10720,"PIKE","GA","Red"
13233,13589,3658,152,17399,"POLK","GA","Red"
13235,2805,1217,37,4059,"PULASKI","GA","Red"
13237,8291,3448,116,11855,"PUTNAM","GA","Red"
13239,604,497,5,1106,"QUITMAN","GA","Red"
13241,7474,1984,110,9568,"RABUN","GA","Red"
13243,1391,1671,12,3074,"RANDOLPH","GA","Blue"
13245,26781,59124,1111,87016,"RICHMOND","GA","Blue"
13247,13012,31244,430,44686,"ROCKDALE","GA","Blue"
13249,1800,462,13,2275,"SCHLEY","GA","Red"
13251,3916,2661,51,6628,"SCREVEN","GA","Red"
13253,2611,1254,19,3884,"SEMINOLE","GA","Red"
13255,18057,11784,275,30116,"SPALDING","GA","Red"
13257,9368,2385,132,11885,"STEPHENS","GA","Red"
13259,801,1182,7,1990,"STEWART","GA","Blue"
13261,5732,6318,100,12150,"SUMTER","GA","Blue"
13263,1392,2114,16,3522,"TALBOT","GA","Blue"
13265,360,561,7,928,"TALIAFERRO","GA","Blue"
13267,6053,2061,69,8183,"TATTNALL","GA","Red"
13269,2418,1387,34,3839,"TAYLOR","GA","Red"
13271,2825,1487,21,4333,"TELFAIR","GA","Red"
13273,2004,2376,36,4416,"TERRELL","GA","Blue"
13275,12954,8708,191,21853,"THOMAS","GA","Red"
13277,10784,5322,177,16283,"TIFT","GA","Red"
13279,7872,2939,103,10914,"TOOMBS","GA","Red"
13281,6384,1550,45,7979,"TOWNS","GA","Red"
13283,2101,952,24,3077,"TREUTLEN","GA","Red"
13285,18143,11578,328,30049,"TROUP","GA","Red"
13287,2349,1410,33,3792,"TURNER","GA","Red"
13289,2370,2044,30,4444,"TWIGGS","GA","Red"
13291,12651,2801,108,15560,"UNION","GA","Red"
13293,8608,4201,96,12905,"UPSON","GA","Red"
13295,23174,5769,411,29354,"WALKER","GA","Red"
13297,37842,12682,571,51095,"WALTON","GA","Red"
13299,9865,4211,116,14192,"WARE","GA","Red"
13301,1166,1469,16,2651,"WARREN","GA","Blue"
13303,4663,4730,66,9459,"WASHINGTON","GA","Blue"
13305,9987,2687,104,12778,"WAYNE","GA","Red"
13307,748,639,3,1390,"WEBSTER","GA","Red"
13309,1583,689,13,2285,"WHEELER","GA","Red"
13311,12222,2411,183,14816,"WHITE","GA","Red"
13313,25636,10670,440,36746,"WHITFIELD","GA","Red"
13315,2403,862,16,3281,"WILCOX","GA","Red"
13317,2823,2160,46,5029,"WILKES","GA","Red"
13319,2664,2075,31,4770,"WILKINSON","GA","Red"
13321,6830,2395,60,9285,"WORTH","GA","Red"
15001,26897,58731,2186,87814,"HAWAII","HI","Blue"
15003,136250,238866,6986,382102,"HONOLULU","HI","Blue"
15007,11582,21225,690,33497,"KAUAI","HI","Blue"
15009,22126,47305,1613,71044,"MAUI","HI","Blue"
16001,130699,120539,8151,259389,"ADA","ID","Red"
16003,1941,591,54,2586,"ADAMS","ID","Red"
16005,23331,14682,1540,39553,"BANNOCK","ID","Red"
16007,2914,350,51,3315,"BEAR LAKE","ID","Red"
16009,3878,977,118,4973,"BENEWAH","ID","Red"
16011,15295,4124,577,19996,"BINGHAM","ID","Red"
16013,4032,8919,338,13289,"BLAINE","ID","Blue"
16015,3485,1204,131,4820,"BOISE","ID","Red"
16017,18369,8310,656,27335,"BONNER","ID","Red"
16019,37805,14254,1936,53995,"BONNEVILLE","ID","Red"
16021,4937,1220,156,6313,"BOUNDARY","ID","Red"
16023,1202,188,25,1415,"BUTTE","ID","Red"
16025,507,149,98,754,"CAMAS","ID","Red"
16027,61759,25881,2770,90410,"CANYON","ID","Red"
16029,2906,431,79,3416,"CARIBOU","ID","Red"
16031,7907,1464,258,9629,"CASSIA","ID","Red"
16033,264,41,6,311,"CLARK","ID","Red"
16035,3453,877,89,4419,"CLEARWATER","ID","Red"
16037,2089,603,47,2739,"CUSTER","ID","Red"
16039,7246,2601,358,10205,"ELMORE","ID","Red"
16041,5845,657,162,6664,"FRANKLIN","ID","Red"
16043,5548,998,173,6719,"FREMONT","ID","Red"
16045,7951,1803,204,9958,"GEM","ID","Red"
16047,4659,1256,135,6050,"GOODING","ID","Red"
16049,7826,1561,215,9602,"IDAHO","ID","Red"
16051,12099,1661,413,14173,"JEFFERSON","ID","Red"
16053,5734,1893,185,7812,"JEROME","ID","Red"
16055,62837,24312,2318,89467,"KOOTENAI","ID","Red"
16057,9472,10236,862,20570,"LATAH","ID","Blue"
16059,3592,1032,114,4738,"LEMHI","ID","Red"
16061,1489,349,32,1870,"LEWIS","ID","Red"
16063,1469,414,57,1940,"LINCOLN","ID","Red"
16065,13559,2666,887,17112,"MADISON","ID","Red"
16067,6265,1550,178,7993,"MINIDOKA","ID","Red"
16069,13738,6686,543,20967,"NEZ PERCE","ID","Red"
16071,2148,249,54,2451,"ONEIDA","ID","Red"
16073,3819,816,107,4742,"OWYHEE","ID","Red"
16075,8862,2161,270,11293,"PAYETTE","ID","Red"
16077,2116,865,93,3074,"POWER","ID","Red"
16079,4216,1693,140,6049,"SHOSHONE","ID","Red"
16081,2858,3318,171,6347,"TETON","ID","Blue"
16083,25897,9391,1213,36501,"TWIN FALLS","ID","Red"
16085,3947,2976,140,7063,"VALLEY","ID","Red"
16087,4154,1073,117,5344,"WASHINGTON","ID","Red"
17001,24220,8633,674,33527,"ADAMS","IL","Red"
17003,1486,1114,18,2618,"ALEXANDER","IL","Red"
17005,5625,2288,232,8145,"BOND","IL","Red"
17007,13883,10542,554,24979,"BOONE","IL","Red"
17009,1931,486,104,2521,"BROWN","IL","Red"
17011,10411,6669,354,17434,"BUREAU","IL","Red"
17013,2046,677,49,2772,"CALHOUN","IL","Red"
17015,5105,2748,171,8024,"CARROLL","IL","Red"
17017,3625,1615,77,5317,"CASS","IL","Red"
17019,35285,57067,2790,95142,"CHAMPAIGN","IL","Blue"
17021,11563,4335,306,16204,"CHRISTIAN","IL","Red"
17023,6226,1993,137,8356,"CLARK","IL","Red"
17025,5629,1129,128,6886,"CLAY","IL","Red"
17027,14304,4493,373,19170,"CLINTON","IL","Red"
17029,14037,8067,502,22606,"COLES","IL","Red"
17031,558269,1725973,37244,2321486,"COOK","IL","Blue"
17033,7043,2202,180,9425,"CRAWFORD","IL","Red"
17035,4601,1142,89,5832,"CUMBERLAND","IL","Red"
17037,21905,24643,1277,47825,"DEKALB","IL","Blue"
17039,5632,2191,201,8024,"DE WITT","IL","Red"
17041,6227,2335,176,8738,"DOUGLAS","IL","Red"
17043,193611,281222,10271,485104,"DUPAGE","IL","Blue"
17045,6193,1887,116,8196,"EDGAR","IL","Red"
17047,2833,488,45,3366,"EDWARDS","IL","Red"
17049,15006,3716,327,19049,"EFFINGHAM","IL","Red"
17051,8055,1826,175,10056,"FAYETTE","IL","Red"
17053,5048,1754,151,6953,"FORD","IL","Red"
17055,13622,4760,244,18626,"FRANKLIN","IL","Red"
17057,9867,6503,308,16678,"FULTON","IL","Red"
17059,2019,622,33,2674,"GALLATIN","IL","Red"
17061,4770,1349,108,6227,"GREENE","IL","Red"
17063,16523,9626,542,26691,"GRUNDY","IL","Red"
17065,3432,824,59,4315,"HAMILTON","IL","Red"
17067,6906,2315,162,9383,"HANCOCK","IL","Red"
17069,1691,449,22,2162,"HARDIN","IL","Red"
17071,2394,1187,66,3647,"HENDERSON","IL","Red"
17073,15300,9797,538,25635,"HENRY","IL","Red"
17075,10877,2908,240,14025,"IROQUOIS","IL","Red"
17077,10890,11181,572,22643,"JACKSON","IL","Blue"
17079,4494,1007,75,5576,"JASPER","IL","Red"
17081,12476,4608,320,17404,"JEFFERSON","IL","Red"
17083,8712,2961,264,11937,"JERSEY","IL","Red"
17085,7166,5109,221,12496,"JO DAVIESS","IL","Red"
17087,5059,1281,97,6437,"JOHNSON","IL","Red"
17089,96775,130166,4935,231876,"KANE","IL","Blue"
17091,28532,20271,1099,49902,"KANKAKEE","IL","Red"
17093,29492,33168,1314,63974,"KENDALL","IL","Blue"
17095,12009,10703,431,23143,"KNOX","IL","Red"
17097,123594,204032,6551,334177,"LAKE","IL","Blue"
17099,30113,22442,1036,53591,"LASALLE","IL","Red"
17101,4886,1419,106,6411,"LAWRENCE","IL","Red"
17103,9630,6407,360,16397,"LEE","IL","Red"
17105,12208,4615,351,17174,"LIVINGSTON","IL","Red"
17107,9136,3840,318,13294,"LOGAN","IL","Red"
17109,7027,4992,266,12285,"MCDONOUGH","IL","Red"
17111,82260,78154,3465,163879,"MCHENRY","IL","Red"
17113,40502,43933,2567,87002,"MCLEAN","IL","Blue"
17115,28589,19847,954,49390,"MACON","IL","Red"
17117,16153,7365,504,24022,"MACOUPIN","IL","Red"
17119,76031,57836,3272,137139,"MADISON","IL","Red"
17121,12678,4524,256,17458,"MARION","IL","Red"
17123,4197,2005,132,6334,"MARSHALL","IL","Red"
17125,4654,1985,127,6766,"MASON","IL","Red"
17127,4997,1725,91,6813,"MASSAC","IL","Red"
17129,4764,2022,142,6928,"MENARD","IL","Red"
17131,5418,3280,195,8893,"MERCER","IL","Red"
17133,14142,6569,437,21148,"MONROE","IL","Red"
17135,9544,3905,278,13727,"MONTGOMERY","IL","Red"
17137,9950,5076,283,15309,"MORGAN","IL","Red"
17139,4964,1662,118,6744,"MOULTRIE","IL","Red"
17141,16248,9428,596,26272,"OGLE","IL","Red"
17143,38252,43578,2143,83973,"PEORIA","IL","Blue"
17145,7313,2612,128,10053,"PERRY","IL","Red"
17147,6248,3329,245,9822,"PIATT","IL","Red"
17149,6332,1484,133,7949,"PIKE","IL","Red"
17151,1722,433,20,2175,"POPE","IL","Red"
17153,1699,891,34,2624,"PULASKI","IL","Red"
17155,1993,1338,59,3390,"PUTNAM","IL","Red"
17157,11076,3592,223,14891,"RANDOLPH","IL","Red"
17159,6089,1830,144,8063,"RICHLAND","IL","Red"
17161,28603,36691,1464,66758,"ROCK ISLAND","IL","Blue"
17163,57150,68325,2616,128091,"ST. CLAIR","IL","Blue"
17165,8103,2789,174,11066,"SALINE","IL","Red"
17167,53485,48917,2350,104752,"SANGAMON","IL","Red"
17169,2773,1068,65,3906,"SCHUYLER","IL","Red"
17171,2114,572,51,2737,"SCOTT","IL","Red"
17173,9426,2504,167,12097,"SHELBY","IL","Red"
17175,2004,815,64,2883,"STARK","IL","Red"
17177,12521,9055,472,22048,"STEPHENSON","IL","Red"
17179,42513,24819,1720,69052,"TAZEWELL","IL","Red"
17181,6161,2579,146,8886,"UNION","IL","Red"
17183,20725,10323,536,31584,"VERMILION","IL","Red"
17185,4237,1253,103,5593,"WABASH","IL","Red"
17187,4676,3090,143,7909,"WARREN","IL","Red"
17189,6115,1641,146,7902,"WASHINGTON","IL","Red"
17191,7176,1187,123,8486,"WAYNE","IL","Red"
17193,5791,1517,113,7421,"WHITE","IL","Red"
17195,14527,12253,595,27375,"WHITESIDE","IL","Red"
17197,155116,183915,6074,345105,"WILL","IL","Blue"
17199,22801,10206,646,33653,"WILLIAMSON","IL","Red"
17201,60861,64056,2792,127709,"WINNEBAGO","IL","Blue"
17203,14799,6160,473,21432,"WOODFORD","IL","Red"
18001,10686,3236,287,14209,"ADAMS","IN","Red"
18003,92083,73189,3810,169082,"ALLEN","IN","Red"
18005,22410,12934,891,36235,"BARTHOLOMEW","IN","Red"
18007,3007,1009,98,4114,"BENTON","IN","Red"
18009,3841,1376,134,5351,"BLACKFORD","IN","Red"
18011,22351,15244,925,38520,"BOONE","IN","Red"
18013,5777,3036,168,8981,"BROWN","IN","Red"
18015,7086,2224,185,9495,"CARROLL","IN","Red"
18017,10552,4304,342,15198,"CASS","IN","Red"
18019,33668,23093,1108,57869,"CLARK","IN","Red"
18021,9499,2552,216,12267,"CLAY","IN","Red"
18023,9334,3361,254,12949,"CLINTON","IN","Red"
18025,3483,1355,106,4944,"CRAWFORD","IN","Red"
18027,9576,2169,209,11954,"DAVIESS","IN","Red"
18029,19528,5446,409,25383,"DEARBORN","IN","Red"
18031,9575,2439,273,12287,"DECATUR","IN","Red"
18033,14237,4966,425,19628,"DEKALB","IN","Red"
18035,26827,20474,890,48191,"DELAWARE","IN","Red"
18037,15033,6292,445,21770,"DUBOIS","IN","Red"
18039,46972,26108,1307,74387,"ELKHART","IN","Red"
18041,7755,2237,144,10136,"FAYETTE","IN","Red"
18043,23400,17511,891,41802,"FLOYD","IN","Red"
18045,6154,1629,203,7986,"FOUNTAIN","IN","Red"
18047,9691,2137,172,12000,"FRANKLIN","IN","Red"
18049,6694,2280,173,9147,"FULTON","IN","Red"
18051,11817,4023,321,16161,"GIBSON","IN","Red"
18053,18543,8015,601,27159,"GRANT","IN","Red"
18055,11103,3389,292,14784,"GREENE","IN","Red"
18057,101587,88390,4022,193999,"HAMILTON","IN","Red"
18059,28996,12895,1020,42911,"HANCOCK","IN","Red"
18061,14565,5343,328,20236,"HARRISON","IN","Red"
18063,53802,32604,2099,88505,"HENDRICKS","IN","Red"
18065,15043,5544,443,21030,"HENRY","IN","Red"
18067,26449,13303,878,40630,"HOWARD","IN","Red"
18069,13147,4255,427,17829,"HUNTINGTON","IN","Red"
18071,14555,4302,381,19238,"JACKSON","IN","Red"
18073,11383,3798,294,15475,"JASPER","IN","Red"
18075,6361,1926,174,8461,"JAY","IN","Red"
18077,9663,4731,303,14697,"JEFFERSON","IN","Red"
18079,9490,2523,238,12251,"JENNINGS","IN","Red"
18081,51219,24736,1663,77618,"JOHNSON","IN","Red"
18083,11655,4067,289,16011,"KNOX","IN","Red"
18085,26499,8364,924,35787,"KOSCIUSKO","IN","Red"
18087,8110,2355,168,10633,"LAGRANGE","IN","Red"
18089,91760,124870,3326,219956,"LAKE","IN","Blue"
18091,25997,22427,968,49392,"LAPORTE","IN","Red"
18093,15601,4961,463,21025,"LAWRENCE","IN","Red"
18095,31215,19524,1054,51793,"MADISON","IN","Red"
18097,134175,247772,7672,389619,"MARION","IN","Blue"
18099,13844,5712,371,19927,"MARSHALL","IN","Red"
18101,4029,1011,104,5144,"MARTIN","IN","Red"
18103,10925,3235,313,14473,"MIAMI","IN","Red"
18105,22071,39861,1219,63151,"MONROE","IN","Blue"
18107,12659,4213,326,17198,"MONTGOMERY","IN","Red"
18109,27512,7781,866,36159,"MORGAN","IN","Red"
18111,4942,1509,140,6591,"NEWTON","IN","Red"
18113,14195,4660,335,19190,"NOBLE","IN","Red"
18115,2054,668,353,3075,"OHIO","IN","Red"
18117,6432,2224,176,8832,"ORANGE","IN","Red"
18119,7286,2420,198,9904,"OWEN","IN","Red"
18121,5400,1503,110,7013,"PARKE","IN","Red"
18123,5345,3203,174,8722,"PERRY","IN","Red"
18125,4692,1415,113,6220,"PIKE","IN","Red"
18127,45008,39746,1755,86509,"PORTER","IN","Red"
18129,9206,3811,219,13236,"POSEY","IN","Red"
18131,4246,1463,97,5806,"PULASKI","IN","Red"
18133,12278,3946,373,16597,"PUTNAM","IN","Red"
18135,8312,2513,245,11070,"RANDOLPH","IN","Red"
18137,11261,2774,236,14271,"RIPLEY","IN","Red"
18139,6035,1754,143,7932,"RUSH","IN","Red"
18141,53164,59896,2178,115238,"ST. JOSEPH","IN","Blue"
18143,7331,2701,135,10167,"SCOTT","IN","Red"
18145,14568,5023,400,19991,"SHELBY","IN","Red"
18147,7357,3213,199,10769,"SPENCER","IN","Red"
18149,7466,2650,174,10290,"STARKE","IN","Red"
18151,11327,4513,322,16162,"STEUBEN","IN","Red"
18153,6691,2153,150,8994,"SULLIVAN","IN","Red"
18155,3133,964,57,4154,"SWITZERLAND","IN","Red"
18157,34581,35017,1850,71448,"TIPPECANOE","IN","Blue"
18159,6110,1834,172,8116,"TIPTON","IN","Red"
18161,2688,736,59,3483,"UNION","IN","Red"
18163,41844,34415,1403,77662,"VANDERBURGH","IN","Red"
18165,5184,2145,152,7481,"VERMILLION","IN","Red"
18167,24545,18123,926,43594,"VIGO","IN","Red"
18169,10762,3494,320,14576,"WABASH","IN","Red"
18171,3401,974,97,4472,"WARREN","IN","Red"
18173,21326,11923,580,33829,"WARRICK","IN","Red"
18175,9114,2784,241,12139,"WASHINGTON","IN","Red"
18177,17567,9524,588,27679,"WAYNE","IN","Red"
18179,10855,2928,267,14050,"WELLS","IN","Red"
18181,7957,3032,177,11166,"WHITE","IN","Red"
18183,12862,4234,460,17556,"WHITLEY","IN","Red"
19001,2922,1198,57,4177,"ADAIR","IA","Red"
19003,1535,590,35,2160,"ADAMS","IA","Red"
19005,4744,2576,102,7422,"ALLAMAKEE","IA","Red"
19007,4522,1891,103,6516,"APPANOOSE","IA","Red"
19009,2299,1071,50,3420,"AUDUBON","IA","Red"
19011,9208,5160,274,14642,"BENTON","IA","Red"
19013,29813,35647,1133,66593,"BLACK HAWK","IA","Blue"
19015,8729,6303,308,15340,"BOONE","IA","Red"
19017,8324,5958,264,14546,"BREMER","IA","Red"
19019,6430,4169,175,10774,"BUCHANAN","IA","Red"
19021,5074,2961,132,8167,"BUENA VISTA","IA","Red"
19023,5556,2424,118,8098,"BUTLER","IA","Red"
19025,3698,1470,90,5258,"CALHOUN","IA","Red"
19027,7766,3454,115,11335,"CARROLL","IA","Red"
19029,4979,2201,96,7276,"CASS","IA","Red"
19031,6184,4337,182,10703,"CEDAR","IA","Red"
19033,12499,10941,361,23801,"CERRO GORDO","IA","Red"
19035,4510,1936,72,6518,"CHEROKEE","IA","Red"
19037,4322,2233,76,6631,"CHICKASAW","IA","Red"
19039,3153,1466,51,4670,"CLARKE","IA","Red"
19041,6158,2662,149,8969,"CLAY","IA","Red"
19043,6119,3340,135,9594,"CLAYTON","IA","Red"
19045,13410,10812,465,24687,"CLINTON","IA","Red"
19047,4862,2220,72,7154,"CRAWFORD","IA","Red"
19049,28162,26879,981,56022,"DALLAS","IA","Red"
19051,3035,1013,54,4102,"DAVIS","IA","Red"
19053,2618,1120,66,3804,"DECATUR","IA","Red"
19055,6688,3157,158,10003,"DELAWARE","IA","Red"
19057,10642,8893,421,19956,"DES MOINES","IA","Red"
19059,7452,3661,131,11244,"DICKINSON","IA","Red"
19061,27358,25657,911,53926,"DUBUQUE","IA","Red"
19063,3268,1520,65,4853,"EMMET","IA","Red"
19065,6174,3835,177,10186,"FAYETTE","IA","Red"
19067,4747,3172,113,8032,"FLOYD","IA","Red"
19069,3433,1626,71,5130,"FRANKLIN","IA","Red"
19071,2717,1080,60,3857,"FREMONT","IA","Red"
19073,3229,1769,59,5057,"GREENE","IA","Red"
19075,4945,2206,125,7276,"GRUNDY","IA","Red"
19077,4280,1985,106,6371,"GUTHRIE","IA","Red"
19079,4982,2843,118,7943,"HAMILTON","IA","Red"
19081,4401,1683,88,6172,"HANCOCK","IA","Red"
19083,5864,2976,149,8989,"HARDIN","IA","Red"
19085,5580,2440,135,8155,"HARRISON","IA","Red"
19087,6525,3275,182,9982,"HENRY","IA","Red"
19089,3133,1772,53,4958,"HOWARD","IA","Red"
19091,3825,1442,60,5327,"HUMBOLDT","IA","Red"
19093,2885,917,47,3849,"IDA","IA","Red"
19095,6035,3547,160,9742,"IOWA","IA","Red"
19097,6957,4029,149,11135,"JACKSON","IA","Red"
19099,12125,7737,322,20184,"JASPER","IA","Red"
19101,4476,4319,164,8959,"JEFFERSON","IA","Red"
19103,23206,59177,1468,83851,"JOHNSON","IA","Blue"
19105,6596,4213,180,10989,"JONES","IA","Red"
19107,3809,1414,80,5303,"KEOKUK","IA","Red"
19109,6288,2696,106,9090,"KOSSUTH","IA","Red"
19111,9808,6541,385,16734,"LEE","IA","Red"
19113,53744,70874,2840,127458,"LINN","IA","Blue"
19115,3506,1726,100,5332,"LOUISA","IA","Red"
19117,3295,1284,51,4630,"LUCAS","IA","Red"
19119,5718,1067,78,6863,"LYON","IA","Red"
19121,6525,3134,165,9824,"MADISON","IA","Red"
19123,8320,2894,190,11404,"MAHASKA","IA","Red"
19125,12722,6178,332,19232,"MARION","IA","Red"
19127,9610,8176,350,18136,"MARSHALL","IA","Red"
19129,5616,2508,144,8268,"MILLS","IA","Red"
19131,3684,2053,85,5822,"MITCHELL","IA","Red"
19133,3262,1407,59,4728,"MONONA","IA","Red"
19135,2978,1078,32,4088,"MONROE","IA","Red"
19137,3666,1583,78,5327,"MONTGOMERY","IA","Red"
19139,10865,9372,434,20671,"MUSCATINE","IA","Red"
19141,5871,1569,111,7551,"O'BRIEN","IA","Red"
19143,2695,601,32,3328,"OSCEOLA","IA","Red"
19145,5328,2086,114,7528,"PAGE","IA","Red"
19147,3378,1519,61,4958,"PALO ALTO","IA","Red"
19149,10515,3494,179,14188,"PLYMOUTH","IA","Red"
19151,2832,933,58,3823,"POCAHONTAS","IA","Red"
19153,107564,146250,4941,258755,"POLK","IA","Blue"
19155,26352,18575,817,45744,"POTTAWATTAMIE","IA","Red"
19157,5673,4306,161,10140,"POWESHIEK","IA","Red"
19159,1974,709,31,2714,"RINGGOLD","IA","Red"
19161,4069,1389,77,5535,"SAC","IA","Red"
19163,43958,46926,1715,92599,"SCOTT","IA","Blue"
19165,4711,1959,125,6795,"SHELBY","IA","Red"
19167,15775,3019,257,19051,"SIOUX","IA","Red"
19169,20541,29175,1322,51038,"STORY","IA","Blue"
19171,5325,3577,146,9048,"TAMA","IA","Red"
19173,2470,746,33,3249,"TAYLOR","IA","Red"
19175,4024,2061,100,6185,"UNION","IA","Red"
19177,2870,875,46,3791,"VAN BUREN","IA","Red"
19179,9536,5821,276,15633,"WAPELLO","IA","Red"
19181,17868,12574,597,31039,"WARREN","IA","Red"
19183,6991,4561,213,11765,"WASHINGTON","IA","Red"
19185,2344,727,38,3109,"WAYNE","IA","Red"
19187,10970,6613,239,17822,"WEBSTER","IA","Red"
19189,3726,2135,109,5970,"WINNEBAGO","IA","Red"
19191,6263,5617,184,12064,"WINNESHIEK","IA","Red"
19193,25926,18704,732,45362,"WOODBURY","IA","Red"
19195,2742,1596,80,4418,"WORTH","IA","Red"
19197,4148,1996,110,6254,"WRIGHT","IA","Red"
20001,4218,1570,104,5892,"ALLEN","KS","Red"
20003,2929,782,81,3792,"ANDERSON","KS","Red"
20005,4906,2359,175,7440,"ATCHISON","KS","Red"
20007,2014,291,37,2342,"BARBER","KS","Red"
20009,8608,2340,182,11130,"BARTON","KS","Red"
20011,5023,1541,112,6676,"BOURBON","KS","Red"
20013,3262,1104,105,4471,"BROWN","KS","Red"
20015,22634,9181,705,32520,"BUTLER","KS","Red"
20017,1123,345,23,1491,"CHASE","KS","Red"
20019,1402,212,25,1639,"CHAUTAUQUA","KS","Red"
20021,6766,2194,168,9128,"CHEROKEE","KS","Red"
20023,1183,224,22,1429,"CHEYENNE","KS","Red"
20025,904,143,20,1067,"CLARK","KS","Red"
20027,3177,894,111,4182,"CLAY","KS","Red"
20029,3242,920,101,4263,"CLOUD","KS","Red"
20031,3489,964,112,4565,"COFFEY","KS","Red"
20033,762,126,28,916,"COMANCHE","KS","Red"
20035,9656,4273,302,14231,"COWLEY","KS","Red"
20037,10045,6179,421,16645,"CRAWFORD","KS","Red"
20039,1260,218,20,1498,"DECATUR","KS","Red"
20041,7126,2060,163,9349,"DICKINSON","KS","Red"
20043,2976,686,47,3709,"DONIPHAN","KS","Red"
20045,17286,40785,1424,59495,"DOUGLAS","KS","Blue"
20047,1141,271,19,1431,"EDWARDS","KS","Red"
20049,1140,195,26,1361,"ELK","KS","Red"
20051,9758,3737,305,13800,"ELLIS","KS","Red"
20053,2148,648,57,2853,"ELLSWORTH","KS","Red"
20055,7236,4325,239,11800,"FINNEY","KS","Red"
20057,5803,2947,165,8915,"FORD","KS","Red"
20059,8479,3690,308,12477,"FRANKLIN","KS","Red"
20061,5323,3983,297,9603,"GEARY","KS","Red"
20063,1291,166,14,1471,"GOVE","KS","Red"
20065,1080,228,29,1337,"GRAHAM","KS","Red"
20067,1936,518,47,2501,"GRANT","KS","Red"
20069,1911,341,36,2288,"GRAY","KS","Red"
20071,549,78,14,641,"GREELEY","KS","Red"
20073,2444,569,64,3077,"GREENWOOD","KS","Red"
20075,698,141,20,859,"HAMILTON","KS","Red"
20077,2168,461,49,2678,"HARPER","KS","Red"
20079,10182,6747,380,17309,"HARVEY","KS","Red"
20081,1122,268,20,1410,"HASKELL","KS","Red"
20083,875,154,16,1045,"HODGEMAN","KS","Red"
20085,4517,1881,186,6584,"JACKSON","KS","Red"
20087,6334,3194,254,9782,"JEFFERSON","KS","Red"
20089,1387,212,29,1628,"JEWELL","KS","Red"
20091,155631,184259,7324,347214,"JOHNSON","KS","Blue"
20093,1164,267,24,1455,"KEARNY","KS","Red"
20095,3130,752,67,3949,"KINGMAN","KS","Red"
20097,980,156,29,1165,"KIOWA","KS","Red"
20099,5735,2655,173,8563,"LABETTE","KS","Red"
20101,762,115,18,895,"LANE","KS","Red"
20103,21610,13886,994,36490,"LEAVENWORTH","KS","Red"
20105,1283,266,30,1579,"LINCOLN","KS","Red"
20107,4048,896,102,5046,"LINN","KS","Red"
20109,1249,186,23,1458,"LOGAN","KS","Red"
20111,7550,6055,383,13988,"LYON","KS","Red"
20113,9964,4134,340,14438,"MCPHERSON","KS","Red"
20115,4465,1516,130,6111,"MARION","KS","Red"
20117,3729,1259,126,5114,"MARSHALL","KS","Red"
20119,1523,263,39,1825,"MEADE","KS","Red"
20121,12308,5247,382,17937,"MIAMI","KS","Red"
20123,2504,558,39,3101,"MITCHELL","KS","Red"
20125,9931,3228,267,13426,"MONTGOMERY","KS","Red"
20127,2124,729,46,2899,"MORRIS","KS","Red"
20129,1034,150,14,1198,"MORTON","KS","Red"
20131,4664,927,93,5684,"NEMAHA","KS","Red"
20133,4970,1796,111,6877,"NEOSHO","KS","Red"
20135,1339,149,25,1513,"NESS","KS","Red"
20137,2007,364,44,2415,"NORTON","KS","Red"
20139,5705,2136,194,8035,"OSAGE","KS","Red"
20141,1629,281,35,1945,"OSBORNE","KS","Red"
20143,2610,506,75,3191,"OTTAWA","KS","Red"
20145,2045,643,51,2739,"PAWNEE","KS","Red"
20147,2418,318,45,2781,"PHILLIPS","KS","Red"
20149,9452,3313,318,13083,"POTTAWATOMIE","KS","Red"
20151,3108,933,96,4137,"PRATT","KS","Red"
20153,1261,214,29,1504,"RAWLINS","KS","Red"
20155,18443,8886,612,27941,"RENO","KS","Red"
20157,2182,424,51,2657,"REPUBLIC","KS","Red"
20159,3262,965,92,4319,"RICE","KS","Red"
20161,11610,12765,796,25171,"RILEY","KS","Blue"
20163,2325,339,35,2699,"ROOKS","KS","Red"
20165,1350,295,32,1677,"RUSH","KS","Red"
20167,2790,600,77,3467,"RUSSELL","KS","Red"
20169,15722,8214,595,24531,"SALINE","KS","Red"
20171,2014,299,41,2354,"SCOTT","KS","Red"
20173,122416,95870,5402,223688,"SEDGWICK","KS","Red"
20175,3372,1833,89,5294,"SEWARD","KS","Red"
20177,40443,43015,2199,85657,"SHAWNEE","KS","Blue"
20179,1282,147,16,1445,"SHERIDAN","KS","Red"
20181,2269,396,62,2727,"SHERMAN","KS","Red"
20183,1763,336,30,2129,"SMITH","KS","Red"
20185,1645,357,32,2034,"STAFFORD","KS","Red"
20187,614,148,14,776,"STANTON","KS","Red"
20189,1760,237,34,2031,"STEVENS","KS","Red"
20191,8105,2591,232,10928,"SUMNER","KS","Red"
20193,3130,625,55,3810,"THOMAS","KS","Red"
20195,1363,242,25,1630,"TREGO","KS","Red"
20197,2845,964,93,3902,"WABAUNSEE","KS","Red"
20199,770,44,11,825,"WALLACE","KS","Red"
20201,2363,475,45,2883,"WASHINGTON","KS","Red"
20203,808,149,11,968,"WICHITA","KS","Red"
20205,3153,723,78,3954,"WILSON","KS","Red"
20207,1228,294,24,1546,"WOODSON","KS","Red"
20209,18934,36788,1063,56785,"WYANDOTTE","KS","Blue"
21001,7276,1392,95,8763,"ADAIR","KY","Red"
21003,7586,1642,135,9363,"ALLEN","KY","Red"
21005,9657,3347,236,13240,"ANDERSON","KY","Red"
21007,3356,825,44,4225,"BALLARD","KY","Red"
21009,14654,5127,274,20055,"BARREN","KY","Red"
21011,3986,1573,68,5627,"BATH","KY","Red"
21013,8140,1789,115,10044,"BELL","KY","Red"
21015,44811,20897,1245,66953,"BOONE","KY","Red"
21017,6190,3296,157,9643,"BOURBON","KY","Red"
21019,14295,7083,363,21741,"BOYD","KY","Red"
21021,8872,5298,297,14467,"BOYLE","KY","Red"
21023,3398,800,46,4244,"BRACKEN","KY","Red"
21025,4265,1301,95,5661,"BREATHITT","KY","Red"
21027,7701,2350,146,10197,"BRECKINRIDGE","KY","Red"
21029,30708,10551,705,41964,"BULLITT","KY","Red"
21031,4960,1079,83,6122,"BUTLER","KY","Red"
21033,4906,1433,89,6428,"CALDWELL","KY","Red"
21035,11351,5794,298,17443,"CALLOWAY","KY","Red"
21037,28482,19373,978,48833,"CAMPBELL","KY","Red"
21039,2159,463,16,2638,"CARLISLE","KY","Red"
21041,2954,1116,65,4135,"CARROLL","KY","Red"
21043,8775,2642,168,11585,"CARTER","KY","Red"
21045,6179,918,74,7171,"CASEY","KY","Red"
21047,15080,8296,487,23863,"CHRISTIAN","KY","Red"
21049,11811,6004,313,18128,"CLARK","KY","Red"
21051,6677,831,82,7590,"CLAY","KY","Red"
21053,4280,603,49,4932,"CLINTON","KY","Red"
21055,3451,731,60,4242,"CRITTENDEN","KY","Red"
21057,2769,508,32,3309,"CUMBERLAND","KY","Red"
21059,31023,17283,934,49240,"DAVIESS","KY","Red"
21061,4828,1227,76,6131,"EDMONSON","KY","Red"
21063,2246,712,37,2995,"ELLIOTT","KY","Red"
21065,5100,1355,83,6538,"ESTILL","KY","Red"
21067,58845,90566,3253,152664,"FAYETTE","KY","Blue"
21069,5534,1474,58,7066,"FLEMING","KY","Red"
21071,12250,3884,217,16351,"FLOYD","KY","Red"
21073,12900,12650,509,26059,"FRANKLIN","KY","Red"
21075,1605,791,25,2421,"FULTON","KY","Red"
21077,2955,822,72,3849,"GALLATIN","KY","Red"
21079,6754,1830,119,8703,"GARRARD","KY","Red"
21081,8725,2205,176,11106,"GRANT","KY","Red"
21083,13206,3559,253,17018,"GRAVES","KY","Red"
21085,9453,2400,130,11983,"GRAYSON","KY","Red"
21087,4838,920,54,5812,"GREEN","KY","Red"
21089,13064,4873,239,18176,"GREENUP","KY","Red"
21091,3145,1351,91,4587,"HANCOCK","KY","Red"
21093,29832,18101,1008,48941,"HARDIN","KY","Red"
21095,9367,1494,110,10971,"HARLAN","KY","Red"
21097,6334,2400,119,8853,"HARRISON","KY","Red"
21099,6345,1908,116,8369,"HART","KY","Red"
21101,12730,7639,319,20688,"HENDERSON","KY","Red"
21103,5843,2142,122,8107,"HENRY","KY","Red"
21105,1714,458,27,2199,"HICKMAN","KY","Red"
21107,15757,5439,313,21509,"HOPKINS","KY","Red"
21109,5453,605,55,6113,"JACKSON","KY","Red"
21111,150619,228288,7186,386093,"JEFFERSON","KY","Blue"
21113,17096,8567,588,26251,"JESSAMINE","KY","Red"
21115,8450,1608,134,10192,"JOHNSON","KY","Red"
21117,48123,32265,1720,82108,"KENTON","KY","Red"
21119,4779,1412,60,6251,"KNOTT","KY","Red"
21121,11012,2114,147,13273,"KNOX","KY","Red"
21123,5685,1504,112,7301,"LARUE","KY","Red"
21125,23234,4474,389,28097,"LAUREL","KY","Red"
21127,5633,1238,84,6955,"LAWRENCE","KY","Red"
21129,2159,459,41,2659,"LEE","KY","Red"
21131,4321,446,44,4811,"LESLIE","KY","Red"
21133,7226,1799,110,9135,"LETCHER","KY","Red"
21135,4986,823,74,5883,"LEWIS","KY","Red"
21137,8489,2254,170,10913,"LINCOLN","KY","Red"
21139,4010,939,54,5003,"LIVINGSTON","KY","Red"
21141,9067,3094,185,12346,"LOGAN","KY","Red"
21143,3100,1092,36,4228,"LYON","KY","Red"
21145,21820,11190,511,33521,"MCCRACKEN","KY","Red"
21147,5664,725,46,6435,"MCCREARY","KY","Red"
21149,3633,1074,75,4782,"MCLEAN","KY","Red"
21151,27353,15580,970,43903,"MADISON","KY","Red"
21153,4174,1213,59,5446,"MAGOFFIN","KY","Red"
21155,6113,2722,93,8928,"MARION","KY","Red"
21157,13297,4071,233,17601,"MARSHALL","KY","Red"
21159,3496,403,31,3930,"MARTIN","KY","Red"
21161,5477,2362,119,7958,"MASON","KY","Red"
21163,10184,3632,294,14110,"MEADE","KY","Red"
21165,2311,750,41,3102,"MENIFEE","KY","Red"
21167,8506,3033,196,11735,"MERCER","KY","Red"
21169,3959,975,78,5012,"METCALFE","KY","Red"
21171,4628,657,45,5330,"MONROE","KY","Red"
21173,8993,3630,214,12837,"MONTGOMERY","KY","Red"
21175,4297,1172,66,5535,"MORGAN","KY","Red"
21177,10496,3544,189,14229,"MUHLENBERG","KY","Red"
21179,15703,7188,354,23245,"NELSON","KY","Red"
21181,2408,955,33,3396,"NICHOLAS","KY","Red"
21183,8582,2404,141,11127,"OHIO","KY","Red"
21185,22651,14504,781,37936,"OLDHAM","KY","Red"
21187,4292,1098,66,5456,"OWEN","KY","Red"
21189,1670,216,9,1895,"OWSLEY","KY","Red"
21191,5515,1322,88,6925,"PENDLETON","KY","Red"
21193,8118,2350,138,10606,"PERRY","KY","Red"
21195,20279,4862,227,25368,"PIKE","KY","Red"
21197,4041,1367,97,5505,"POWELL","KY","Red"
21199,25441,5664,432,31537,"PULASKI","KY","Red"
21201,884,253,9,1146,"ROBERTSON","KY","Red"
21203,6577,1134,72,7783,"ROCKCASTLE","KY","Red"
21205,5994,3880,184,10058,"ROWAN","KY","Red"
21207,7506,1329,104,8939,"RUSSELL","KY","Red"
21209,17764,10564,622,28950,"SCOTT","KY","Red"
21211,15054,8076,412,23542,"SHELBY","KY","Red"
21213,5888,2681,163,8732,"SIMPSON","KY","Red"
21215,8737,2530,162,11429,"SPENCER","KY","Red"
21217,9376,2961,173,12510,"TAYLOR","KY","Red"
21219,4060,1202,89,5351,"TODD","KY","Red"
21221,5487,1791,97,7375,"TRIGG","KY","Red"
21223,3227,1012,80,4319,"TRIMBLE","KY","Red"
21225,4965,1529,82,6576,"UNION","KY","Red"
21227,31790,22477,1084,55351,"WARREN","KY","Red"
21229,4482,1644,97,6223,"WASHINGTON","KY","Red"
21231,7430,1700,110,9240,"WAYNE","KY","Red"
21233,4506,1412,73,5991,"WEBSTER","KY","Red"
21235,12567,2552,228,15347,"WHITLEY","KY","Red"
21237,2097,839,43,2979,"WOLFE","KY","Red"
21239,8362,6530,319,15211,"WOODFORD","KY","Red"
22001,22596,5443,386,28425,"ACADIA","LA","Red"
22003,7574,2108,128,9810,"ALLEN","LA","Red"
22005,40687,20399,1239,62325,"ASCENSION","LA","Red"
22007,7271,3833,131,11235,"ASSUMPTION","LA","Red"
22009,12028,4979,285,17292,"AVOYELLES","LA","Red"
22011,13575,2542,240,16357,"BEAUREGARD","LA","Red"
22013,3891,3067,92,7050,"BIENVILLE","LA","Red"
22015,38074,15662,919,54655,"BOSSIER","LA","Red"
22017,48021,55110,1781,104912,"CADDO","LA","Blue"
22019,55066,25982,1615,82663,"CALCASIEU","LA","Red"
22021,3976,745,41,4762,"CALDWELL","LA","Red"
22023,3671,324,44,4039,"CAMERON","LA","Red"
22025,3541,1269,48,4858,"CATAHOULA","LA","Red"
22027,3770,2731,79,6580,"CLAIBORNE","LA","Red"
22029,5550,3177,101,8828,"CONCORDIA","LA","Red"
22031,9112,5457,167,14736,"DE SOTO","LA","Red"
22033,88420,115577,4185,208182,"EAST BATON ROUGE","LA","Blue"
22035,1080,1900,56,3036,"EAST CARROLL","LA","Blue"
22037,6064,4280,165,10509,"EAST FELICIANA","LA","Red"
22039,11053,4158,201,15412,"EVANGELINE","LA","Red"
22041,6970,2658,92,9720,"FRANKLIN","LA","Red"
22043,8117,1157,118,9392,"GRANT","LA","Red"
22045,21251,11027,435,32713,"IBERIA","LA","Red"
22047,7893,8514,312,16719,"IBERVILLE","LA","Blue"
22049,5394,2143,95,7632,"JACKSON","LA","Red"
22051,105949,84477,3307,193733,"JEFFERSON","LA","Red"
22053,11423,3208,210,14841,"JEFFERSON DAVIS","LA","Red"
22055,72519,39685,2317,114521,"LAFAYETTE","LA","Red"
22057,36024,8672,692,45388,"LAFOURCHE","LA","Red"
22059,6378,638,61,7077,"LA SALLE","LA","Red"
22061,11311,7559,405,19275,"LINCOLN","LA","Red"
22063,54877,9249,1104,65230,"LIVINGSTON","LA","Red"
22065,1930,2654,86,4670,"MADISON","LA","Blue"
22067,6510,4946,118,11574,"MOREHOUSE","LA","Red"
22069,9358,6896,300,16554,"NATCHITOCHES","LA","Red"
22071,26664,147854,3301,177819,"ORLEANS","LA","Blue"
22073,42255,25913,998,69166,"OUACHITA","LA","Red"
22075,7412,3414,188,11014,"PLAQUEMINES","LA","Red"
22077,7503,4683,185,12371,"POINTE COUPEE","LA","Red"
22079,38347,19475,1043,58865,"RAPIDES","LA","Red"
22081,2413,1644,75,4132,"RED RIVER","LA","Red"
22083,6607,3225,108,9940,"RICHLAND","LA","Red"
22085,8776,1731,89,10596,"SABINE","LA","Red"
22087,11179,6151,320,17650,"ST. BERNARD","LA","Red"
22089,18233,9800,484,28517,"ST. CHARLES","LA","Red"
22091,2714,3346,98,6158,"ST. HELENA","LA","Blue"
22093,5954,6510,126,12590,"ST. JAMES","LA","Blue"
22095,7538,13582,312,21432,"ST. JOHN THE BAPTIST","LA","Blue"
22097,23171,17372,611,41154,"ST. LANDRY","LA","Red"
22099,18203,8439,396,27038,"ST. MARTIN","LA","Red"
22101,14811,8055,320,23186,"ST. MARY","LA","Red"
22103,99666,37746,2698,140110,"ST. TAMMANY","LA","Red"
22105,37806,18887,968,57661,"TANGIPAHOA","LA","Red"
22107,1197,1329,28,2554,"TENSAS","LA","Blue"
22109,34339,11198,703,46240,"TERREBONNE","LA","Red"
22111,8407,2654,140,11201,"UNION","LA","Red"
22113,21930,5009,385,27324,"VERMILION","LA","Red"
22115,14107,2898,263,17268,"VERNON","LA","Red"
22117,13307,5970,236,19513,"WASHINGTON","LA","Red"
22119,11830,6172,214,18216,"WEBSTER","LA","Red"
22121,7684,6200,213,14097,"WEST BATON ROUGE","LA","Red"
22123,4317,710,25,5052,"WEST CARROLL","LA","Red"
22125,3863,2298,107,6268,"WEST FELICIANA","LA","Red"
22127,4619,1543,63,6225,"WINN","LA","Red"
23001,29268,27617,2476,59361,"ANDROSCOGGIN","ME","Red"
23003,21080,13956,1174,36210,"AROOSTOOK","ME","Red"
23005,59584,128759,7571,195914,"CUMBERLAND","ME","Blue"
23007,8754,8069,776,17599,"FRANKLIN","ME","Red"
23009,14982,19369,1325,35676,"HANCOCK","ME","Blue"
23011,34721,34902,2992,72615,"KENNEBEC","ME","Blue"
23013,9982,15110,940,26032,"KNOX","ME","Blue"
23015,10256,12684,917,23857,"LINCOLN","ME","Blue"
23017,17698,14755,1357,33810,"OXFORD","ME","Red"
23019,44825,37713,3595,86133,"PENOBSCOT","ME","Red"
23021,6143,3517,336,9996,"PISCATAQUIS","ME","Red"
23023,9755,13528,997,24280,"SAGADAHOC","ME","Blue"
23025,16644,10199,1030,27873,"SOMERSET","ME","Red"
23027,11196,12345,1025,24566,"WALDO","ME","Blue"
23029,10194,6761,615,17570,"WASHINGTON","ME","Red"
23031,54817,71189,5036,131042,"YORK","ME","Blue"
24001,20886,9158,597,30641,"ALLEGANY","MD","Red"
24003,127821,172823,8973,309617,"ANNE ARUNDEL","MD","Blue"
24005,146202,258409,10321,414932,"BALTIMORE","MD","Blue"
24009,25346,22587,1180,49113,"CALVERT","MD","Red"
24011,10283,5095,416,15794,"CAROLINE","MD","Red"
24013,60218,36456,3653,100327,"CARROLL","MD","Red"
24015,29439,16809,1214,47462,"CECIL","MD","Red"
24017,25579,62171,1748,89498,"CHARLES","MD","Blue"
24019,8764,6857,356,15977,"DORCHESTER","MD","Red"
24021,63682,77675,4258,145615,"FREDERICK","MD","Blue"
24023,12002,3281,328,15611,"GARRETT","MD","Red"
24025,80930,63095,4161,148186,"HARFORD","MD","Red"
24027,48390,129433,5239,183062,"HOWARD","MD","Blue"
24029,5195,5329,270,10794,"KENT","MD","Blue"
24031,101222,419569,12952,533743,"MONTGOMERY","MD","Blue"
24033,37090,379208,8557,424855,"PRINCE GEORGE'S","MD","Blue"
24035,18741,10709,840,30290,"QUEEN ANNE'S","MD","Red"
24037,30826,23138,1701,55665,"ST MARY'S","MD","Red"
24039,5739,4241,167,10147,"SOMERSET","MD","Red"
24041,10946,11062,547,22555,"TALBOT","MD","Blue"
24043,40224,26044,1511,67779,"WASHINGTON","MD","Red"
24045,22944,22054,1218,46216,"WICOMICO","MD","Red"
24047,18571,12560,560,31691,"WORCESTER","MD","Red"
24510,25374,207260,4827,237461,"BALTIMORE CITY","MD","Blue"
25001,55311,91994,4207,151512,"BARNSTABLE","MA","Blue"
25003,18064,51705,2002,71771,"BERKSHIRE","MA","Blue"
25005,119872,153377,8115,281364,"BRISTOL","MA","Blue"
25007,2631,9914,328,12873,"DUKES","MA","Blue"
25009,144837,267198,12564,424599,"ESSEX","MA","Blue"
25011,11201,30030,1772,43003,"FRANKLIN","MA","Blue"
25013,87318,125948,7527,220793,"HAMPDEN","MA","Blue"
25015,22281,63362,2689,88332,"HAMPSHIRE","MA","Blue"
25017,226956,617196,25195,869347,"MIDDLESEX","MA","Blue"
25019,1914,5241,183,7338,"NANTUCKET","MA","Blue"
25021,125294,273312,12436,411042,"NORFOLK","MA","Blue"
25023,121227,173630,9013,303870,"PLYMOUTH","MA","Blue"
25025,58613,270522,8105,337240,"SUFFOLK","MA","Blue"
25027,171683,248773,14465,434921,"WORCESTER","MA","Blue"
26001,4848,2142,74,7064,"ALCONA","MI","Red"
26003,3014,2053,61,5128,"ALGER","MI","Red"
26005,41392,24449,1253,67094,"ALLEGAN","MI","Red"
26007,10686,6000,283,16969,"ALPENA","MI","Red"
26009,9748,5960,241,15949,"ANTRIM","MI","Red"
26011,5928,2774,129,8831,"ARENAC","MI","Red"
26013,2512,1478,48,4038,"BARAGA","MI","Red"
26015,23471,11797,637,35905,"BARRY","MI","Red"
26017,33125,26151,979,60255,"BAY","MI","Red"
26019,6601,5480,181,12262,"BENZIE","MI","Red"
26021,43519,37438,1434,82391,"BERRIEN","MI","Red"
26023,14064,6159,313,20536,"BRANCH","MI","Red"
26025,36221,28877,1183,66281,"CALHOUN","MI","Red"
26027,16699,9130,387,26216,"CASS","MI","Red"
26029,9841,6939,220,17000,"CHARLEVOIX","MI","Red"
26031,10186,5437,245,15868,"CHEBOYGAN","MI","Red"
26033,10681,6648,313,17642,"CHIPPEWA","MI","Red"
26035,10861,5199,221,16281,"CLARE","MI","Red"
26037,25098,21968,861,47927,"CLINTON","MI","Red"
26039,5087,2672,102,7861,"CRAWFORD","MI","Red"
26041,13207,7606,338,21151,"DELTA","MI","Red"
26043,9617,4744,228,14589,"DICKINSON","MI","Red"
26045,31798,31299,1230,64327,"EATON","MI","Red"
26047,12135,9662,380,22177,"EMMET","MI","Red"
26049,98714,119390,3256,221360,"GENESEE","MI","Blue"
26051,9893,4524,186,14603,"GLADWIN","MI","Red"
26053,4600,3570,96,8266,"GOGEBIC","MI","Red"
26055,30502,28683,1051,60236,"GRAND TRAVERSE","MI","Red"
26057,12102,6693,332,19127,"GRATIOT","MI","Red"
26059,17037,5883,382,23302,"HILLSDALE","MI","Red"
26061,10378,7750,373,18501,"HOUGHTON","MI","Red"
26063,12731,5490,216,18437,"HURON","MI","Red"
26065,47639,94212,2699,144550,"INGHAM","MI","Blue"
26067,20657,10901,651,32209,"IONIA","MI","Red"
26069,9759,5373,231,15363,"IOSCO","MI","Red"
26071,4216,2493,80,6789,"IRON","MI","Red"
26073,14815,14072,534,29421,"ISABELLA","MI","Red"
26075,47372,31995,1494,80861,"JACKSON","MI","Red"
26077,56823,83686,2905,143414,"KALAMAZOO","MI","Blue"
26079,7436,3002,193,10631,"KALKASKA","MI","Red"
26081,165741,187915,7392,361048,"KENT","MI","Blue"
26083,862,672,23,1557,"KEWEENAW","MI","Red"
26085,3946,2288,89,6323,"LAKE","MI","Red"
26087,35482,16367,801,52650,"LAPEER","MI","Red"
26089,7916,8795,189,16900,"LEELANAU","MI","Blue"
26091,31541,20918,916,53375,"LENAWEE","MI","Red"
26093,76982,48220,1995,127197,"LIVINGSTON","MI","Red"
26095,2109,842,50,3001,"LUCE","MI","Red"
26097,4304,2632,79,7015,"MACKINAC","MI","Red"
26099,263863,223952,6441,494256,"MACOMB","MI","Red"
26101,8321,6107,227,14655,"MANISTEE","MI","Red"
26103,16286,20465,711,37462,"MARQUETTE","MI","Blue"
26105,10207,6802,245,17254,"MASON","MI","Red"
26107,13267,7375,407,21049,"MECOSTA","MI","Red"
26109,8117,4316,174,12607,"MENOMINEE","MI","Red"
26111,27675,20493,920,49088,"MIDLAND","MI","Red"
26113,6648,1967,140,8755,"MISSAUKEE","MI","Red"
26115,52710,32975,1463,87148,"MONROE","MI","Red"
26117,21815,9703,582,32100,"MONTCALM","MI","Red"
26119,4171,1628,60,5859,"MONTMORENCY","MI","Red"
26121,45133,45643,1668,92444,"MUSKEGON","MI","Blue"
26123,18857,7873,431,27161,"NEWAYGO","MI","Red"
26125,325971,434148,10232,770351,"OAKLAND","MI","Blue"
26127,8892,4944,226,14062,"OCEANA","MI","Red"
26129,8253,3475,179,11907,"OGEMAW","MI","Red"
26131,2358,1391,55,3804,"ONTONAGON","MI","Red"
26133,8928,3214,187,12329,"OSCEOLA","MI","Red"
26135,3466,1342,66,4874,"OSCODA","MI","Red"
26137,9779,4743,235,14757,"OTSEGO","MI","Red"
26139,100913,64705,3095,168713,"OTTAWA","MI","Red"
26141,5342,2911,91,8344,"PRESQUE ISLE","MI","Red"
26143,9670,5166,182,15018,"ROSCOMMON","MI","Red"
26145,50785,51088,1476,103349,"SAGINAW","MI","Blue"
26147,59185,31363,1516,92064,"ST. CLAIR","MI","Red"
26149,18127,9262,547,27936,"ST. JOSEPH","MI","Red"
26151,16194,5966,286,22446,"SANILAC","MI","Red"
26153,3090,1589,66,4745,"SCHOOLCRAFT","MI","Red"
26155,23149,15347,728,39224,"SHIAWASSEE","MI","Red"
26157,20297,8712,436,29445,"TUSCOLA","MI","Red"
26159,21591,16803,672,39066,"VAN BUREN","MI","Red"
26161,56241,157136,3041,216418,"WASHTENAW","MI","Blue"
26163,264553,597170,10746,872469,"WAYNE","MI","Blue"
26165,12102,5838,325,18265,"WEXFORD","MI","Red"
27001,6258,3607,160,10025,"AITKIN","MN","Red"
27003,104902,100893,5337,211132,"ANOKA","MN","Red"
27005,12438,6589,374,19401,"BECKER","MN","Red"
27007,12188,11426,575,24189,"BELTRAMI","MN","Red"
27009,14382,7280,598,22260,"BENTON","MN","Red"
27011,1863,1053,58,2974,"BIG STONE","MN","Red"
27013,16731,18330,990,36051,"BLUE EARTH","MN","Blue"
27015,9552,4753,330,14635,"BROWN","MN","Red"
27017,9791,10098,480,20369,"CARLTON","MN","Blue"
27019,34009,30774,1578,66361,"CARVER","MN","Red"
27021,11620,6342,327,18289,"CASS","MN","Red"
27023,4250,2226,135,6611,"CHIPPEWA","MN","Red"
27025,21916,11806,848,34570,"CHISAGO","MN","Red"
27027,15043,16357,839,32239,"CLAY","MN","Blue"
27029,3372,1260,76,4708,"CLEARWATER","MN","Red"
27031,1203,2496,107,3806,"COOK","MN","Blue"
27033,4165,1834,108,6107,"COTTONWOOD","MN","Red"
27035,25676,13726,771,40173,"CROW WING","MN","Red"
27037,109638,146155,6466,262259,"DAKOTA","MN","Blue"
27039,7783,4079,325,12187,"DODGE","MN","Red"
27041,15799,7868,498,24165,"DOUGLAS","MN","Red"
27043,5191,2531,192,7914,"FARIBAULT","MN","Red"
27045,7301,4551,289,12141,"FILLMORE","MN","Red"
27047,9578,6889,351,16818,"FREEBORN","MN","Red"
27049,16052,11806,778,28636,"GOODHUE","MN","Red"
27051,2269,1300,85,3654,"GRANT","MN","Red"
27053,205973,532623,17373,755969,"HENNEPIN","MN","Blue"
27055,6334,4853,253,11440,"HOUSTON","MN","Red"
27057,8202,4462,301,12965,"HUBBARD","MN","Red"
27059,16491,7138,606,24235,"ISANTI","MN","Red"
27061,15239,10786,536,26561,"ITASCA","MN","Red"
27063,3948,1745,126,5819,"JACKSON","MN","Red"
27065,6278,2774,190,9242,"KANABEC","MN","Red"
27067,14437,8440,490,23367,"KANDIYOHI","MN","Red"
27069,1546,1006,87,2639,"KITTSON","MN","Red"
27071,4131,2659,132,6922,"KOOCHICHING","MN","Red"
27073,2528,1446,66,4040,"LAC QUI PARLE","MN","Red"
27075,3393,3647,162,7202,"LAKE","MN","Blue"
27077,1704,671,33,2408,"LAKE OF THE WOODS","MN","Red"
27079,10775,5672,371,16818,"LE SUEUR","MN","Red"
27081,2121,937,57,3115,"LINCOLN","MN","Red"
27083,7979,4634,280,12893,"LYON","MN","Red"
27085,13986,6413,534,20933,"MCLEOD","MN","Red"
27087,1142,1112,50,2304,"MAHNOMEN","MN","Red"
27089,3721,1295,97,5113,"MARSHALL","MN","Red"
27091,7480,3305,224,11009,"MARTIN","MN","Red"
27093,9359,3867,303,13529,"MEEKER","MN","Red"
27095,9952,4404,333,14689,"MILLE LACS","MN","Red"
27097,14821,4367,370,19558,"MORRISON","MN","Red"
27099,10025,8899,421,19345,"MOWER","MN","Red"
27101,3363,1449,84,4896,"MURRAY","MN","Red"
27103,9018,9622,485,19125,"NICOLLET","MN","Blue"
27105,5600,2933,182,8715,"NOBLES","MN","Red"
27107,1953,1404,84,3441,"NORMAN","MN","Red"
27109,39692,49491,2202,91385,"OLMSTED","MN","Blue"
27111,23800,11958,641,36399,"OTTER TAIL","MN","Red"
27113,4532,2568,177,7277,"PENNINGTON","MN","Red"
27115,10256,5419,326,16001,"PINE","MN","Red"
27117,3553,1306,81,4940,"PIPESTONE","MN","Red"
27119,9865,5439,290,15594,"POLK","MN","Red"
27121,4417,2477,128,7022,"POPE","MN","Red"
27123,77376,211620,6981,295977,"RAMSEY","MN","Blue"
27125,1454,691,51,2196,"RED LAKE","MN","Red"
27127,5771,2355,158,8284,"REDWOOD","MN","Red"
27129,5467,2496,165,8128,"RENVILLE","MN","Red"
27131,17464,17402,820,35686,"RICE","MN","Red"
27133,3583,1556,101,5240,"ROCK","MN","Red"
27135,6065,2188,168,8421,"ROSEAU","MN","Red"
27137,49017,67704,2810,119531,"SAINT LOUIS","MN","Blue"
27139,45872,40040,2053,87965,"SCOTT","MN","Red"
27141,36222,18065,1325,55612,"SHERBURNE","MN","Red"
27143,5864,2417,171,8452,"SIBLEY","MN","Red"
27145,50959,31879,1997,84835,"STEARNS","MN","Red"
27147,12656,7917,555,21128,"STEELE","MN","Red"
27149,3044,1922,119,5085,"STEVENS","MN","Red"
27151,3316,1784,93,5193,"SWIFT","MN","Red"
27153,9753,3286,218,13257,"TODD","MN","Red"
27155,1172,661,31,1864,"TRAVERSE","MN","Red"
27157,8153,4696,274,13123,"WABASHA","MN","Red"
27159,5520,2023,134,7677,"WADENA","MN","Red"
27161,6624,3496,269,10389,"WASECA","MN","Red"
27163,73764,89165,3857,166786,"WASHINGTON","MN","Blue"
27165,3103,1987,111,5201,"WATONWAN","MN","Red"
27167,2328,1026,76,3430,"WILKIN","MN","Red"
27169,13227,13333,613,27173,"WINONA","MN","Blue"
27171,51973,28430,2023,82426,"WRIGHT","MN","Red"
27173,3734,1688,106,5528,"YELLOW MEDICINE","MN","Red"
28001,5696,7917,146,13759,"ADAMS","MS","Blue"
28003,12818,2782,193,15793,"ALCORN","MS","Red"
28005,4503,2620,73,7196,"AMITE","MS","Red"
28007,5178,3542,103,8823,"ATTALA","MS","Red"
28009,2570,1679,40,4289,"BENTON","MS","Red"
28011,4671,8904,169,13744,"BOLIVAR","MS","Blue"
28013,4625,1902,63,6590,"CALHOUN","MS","Red"
28015,3924,1729,48,5701,"CARROLL","MS","Red"
28017,4175,3810,156,8141,"CHICKASAW","MS","Red"
28019,3001,1185,37,4223,"CHOCTAW","MS","Red"
28021,603,3772,74,4449,"CLAIBORNE","MS","Blue"
28023,5417,2838,83,8338,"CLARKE","MS","Red"
28025,4181,5844,164,10189,"CLAY","MS","Blue"
28027,2375,6020,106,8501,"COAHOMA","MS","Blue"
28029,6250,6470,163,12883,"COPIAH","MS","Blue"
28031,5854,3416,90,9360,"COVINGTON","MS","Red"
28033,46462,28265,1397,76124,"DESOTO","MS","Red"
28035,17290,13755,609,31654,"FORREST","MS","Red"
28037,2923,1480,58,4461,"FRANKLIN","MS","Red"
28039,9713,1218,118,11049,"GEORGE","MS","Red"
28041,4794,966,52,5812,"GREENE","MS","Red"
28043,6081,4734,96,10911,"GRENADA","MS","Red"
28045,16132,4504,321,20957,"HANCOCK","MS","Red"
28047,46822,27728,1218,75768,"HARRISON","MS","Red"
28049,25141,73550,1304,99995,"HINDS","MS","Blue"
28051,1369,6588,158,8115,"HOLMES","MS","Blue"
28053,1118,3016,55,4189,"HUMPHREYS","MS","Blue"
28055,308,355,13,676,"ISSAQUENA","MS","Blue"
28057,9438,1249,132,10819,"ITAWAMBA","MS","Red"
28059,36295,17375,873,54543,"JACKSON","MS","Red"
28061,4302,4341,93,8736,"JASPER","MS","Blue"
28063,531,3327,50,3908,"JEFFERSON","MS","Blue"
28065,2534,3599,80,6213,"JEFFERSON DAVIS","MS","Blue"
28067,21226,8517,348,30091,"JONES","MS","Red"
28069,1787,2887,57,4731,"KEMPER","MS","Blue"
28071,12949,10070,404,23423,"LAFAYETTE","MS","Red"
28073,20704,7340,441,28485,"LAMAR","MS","Red"
28075,17967,12960,320,31247,"LAUDERDALE","MS","Red"
28077,4285,2260,68,6613,"LAWRENCE","MS","Red"
28079,5228,3897,75,9200,"LEAKE","MS","Red"
28081,24207,12189,558,36954,"LEE","MS","Red"
28083,3129,7648,116,10893,"LEFLORE","MS","Blue"
28085,11596,5040,165,16801,"LINCOLN","MS","Red"
28087,13800,13087,354,27241,"LOWNDES","MS","Red"
28089,31091,24440,681,56212,"MADISON","MS","Red"
28091,8273,3787,117,12177,"MARION","MS","Red"
28093,7566,8057,194,15817,"MARSHALL","MS","Blue"
28095,11177,5874,208,17259,"MONROE","MS","Red"
28097,2917,2121,37,5075,"MONTGOMERY","MS","Red"
28099,8320,3260,123,11703,"NESHOBA","MS","Red"
28101,6997,3075,111,10183,"NEWTON","MS","Red"
28103,1240,4040,59,5339,"NOXUBEE","MS","Blue"
28105,9004,10299,454,19757,"OKTIBBEHA","MS","Blue"
28107,8060,7403,164,15627,"PANOLA","MS","Red"
28109,19595,4148,290,24033,"PEARL RIVER","MS","Red"
28111,4500,1362,54,5916,"PERRY","MS","Red"
28113,8479,8646,217,17342,"PIKE","MS","Blue"
28115,11550,2614,197,14361,"PONTOTOC","MS","Red"
28117,8370,2153,121,10644,"PRENTISS","MS","Red"
28119,1026,2150,50,3226,"QUITMAN","MS","Blue"
28121,50895,18847,913,70655,"RANKIN","MS","Red"
28123,6285,4330,118,10733,"SCOTT","MS","Red"
28125,688,1465,30,2183,"SHARKEY","MS","Blue"
28127,7635,4037,143,11815,"SIMPSON","MS","Red"
28129,6458,1791,78,8327,"SMITH","MS","Red"
28131,5964,1802,112,7878,"STONE","MS","Red"
28133,2799,6781,101,9681,"SUNFLOWER","MS","Blue"
28135,2488,3105,92,5685,"TALLAHATCHIE","MS","Blue"
28137,8707,4183,203,13093,"TATE","MS","Red"
28139,8054,1937,111,10102,"TIPPAH","MS","Red"
28141,7933,1059,146,9138,"TISHOMINGO","MS","Red"
28143,926,2580,56,3562,"TUNICA","MS","Blue"
28145,10373,2160,150,12683,"UNION","MS","Red"
28147,4220,2835,64,7119,"WALTHALL","MS","Red"
28149,10365,10442,246,21053,"WARREN","MS","Blue"
28151,5300,12503,205,18008,"WASHINGTON","MS","Blue"
28153,6307,3624,125,10056,"WAYNE","MS","Red"
28155,4291,1043,61,5395,"WEBSTER","MS","Red"
28157,1324,2749,54,4127,"WILKINSON","MS","Blue"
28159,5112,4040,84,9236,"WINSTON","MS","Red"
28161,3671,2785,79,6535,"YALOBUSHA","MS","Red"
28163,4832,5496,108,10436,"YAZOO","MS","Blue"
29001,6413,3710,213,10336,"ADAIR","MO","Red"
29003,7255,2351,146,9752,"ANDREW","MO","Red"
29005,2199,564,51,2814,"ATCHISON","MO","Red"
29007,7732,2704,220,10656,"AUDRAIN","MO","Red"
29009,12425,2948,225,15598,"BARRY","MO","Red"
29011,5168,844,65,6077,"BARTON","MO","Red"
29013,6597,1672,147,8416,"BATES","MO","Red"
29015,8109,2180,187,10476,"BENTON","MO","Red"
29017,5167,750,66,5983,"BOLLINGER","MO","Red"
29019,38646,50064,2458,91168,"BOONE","MO","Blue"
29021,22450,13445,703,36598,"BUCHANAN","MO","Red"
29023,14602,3301,238,18141,"BUTLER","MO","Red"
29025,3725,897,60,4682,"CALDWELL","MO","Red"
29027,14815,5870,459,21144,"CALLAWAY","MO","Red"
29029,18850,5652,310,24812,"CAMDEN","MO","Red"
29031,28907,10760,661,40328,"CAPE GIRARDEAU","MO","Red"
29033,3706,786,40,4532,"CARROLL","MO","Red"
29035,2451,418,28,2897,"CARTER","MO","Red"
29037,37197,19052,1159,57408,"CASS","MO","Red"
29039,5788,1145,111,7044,"CEDAR","MO","Red"
29041,3111,916,50,4077,"CHARITON","MO","Red"
29043,34920,11131,788,46839,"CHRISTIAN","MO","Red"
29045,2672,678,44,3394,"CLARK","MO","Red"
29047,64605,59400,2564,126569,"CLAY","MO","Red"
29049,7799,2896,193,10888,"CLINTON","MO","Red"
29051,26086,12694,749,39529,"COLE","MO","Red"
29053,6272,2249,172,8693,"COOPER","MO","Red"
29055,8725,2113,135,10973,"CRAWFORD","MO","Red"
29057,3414,656,49,4119,"DADE","MO","Red"
29059,6619,1380,105,8104,"DALLAS","MO","Red"
29061,3102,746,63,3911,"DAVIESS","MO","Red"
29063,3828,930,85,4843,"DEKALB","MO","Red"
29065,5987,1056,99,7142,"DENT","MO","Red"
29067,5898,1016,86,7000,"DOUGLAS","MO","Red"
29069,8135,2200,84,10419,"DUNKLIN","MO","Red"
29071,38058,14569,1058,53685,"FRANKLIN","MO","Red"
29073,6222,1601,100,7923,"GASCONADE","MO","Red"
29075,2581,613,43,3237,"GENTRY","MO","Red"
29077,83630,55068,3102,141800,"GREENE","MO","Red"
29079,3585,799,53,4437,"GRUNDY","MO","Red"
29081,3198,597,31,3826,"HARRISON","MO","Red"
29083,8027,2619,142,10788,"HENRY","MO","Red"
29085,3966,1056,58,5080,"HICKORY","MO","Red"
29087,1976,338,29,2343,"HOLT","MO","Red"
29089,3553,1413,126,5092,"HOWARD","MO","Red"
29091,15181,3218,251,18650,"HOWELL","MO","Red"
29093,3596,945,51,4592,"IRON","MO","Red"
29095,100142,92182,4094,196418,"JACKSON","MO","Red"
29097,37728,13549,1075,52352,"JASPER","MO","Red"
29099,77046,37523,2119,116688,"JEFFERSON","MO","Red"
29101,15489,6974,660,23123,"JOHNSON","MO","Red"
29103,1486,340,28,1854,"KNOX","MO","Red"
29105,13762,2780,251,16793,"LACLEDE","MO","Red"
29107,12273,4472,310,17055,"LAFAYETTE","MO","Red"
29109,14426,3214,265,17905,"LAWRENCE","MO","Red"
29111,3553,984,72,4609,"LEWIS","MO","Red"
29113,21848,6607,563,29018,"LINCOLN","MO","Red"
29115,4363,1275,88,5726,"LINN","MO","Red"
29117,5267,1410,81,6758,"LIVINGSTON","MO","Red"
29119,7465,1439,149,9053,"MCDONALD","MO","Red"
29121,6076,1662,98,7836,"MACON","MO","Red"
29123,4584,1019,73,5676,"MADISON","MO","Red"
29125,3892,814,65,4771,"MARIES","MO","Red"
29127,9915,3202,231,13348,"MARION","MO","Red"
29129,1541,222,16,1779,"MERCER","MO","Red"
29131,10176,2038,168,12382,"MILLER","MO","Red"
29133,3537,1178,41,4756,"MISSISSIPPI","MO","Red"
29135,5744,1308,105,7157,"MONITEAU","MO","Red"
29137,3477,936,70,4483,"MONROE","MO","Red"
29139,4465,1208,99,5772,"MONTGOMERY","MO","Red"
29141,7442,1924,121,9487,"MORGAN","MO","Red"
29143,5447,1748,55,7250,"NEW MADRID","MO","Red"
29145,22120,5818,467,28405,"NEWTON","MO","Red"
29147,6865,2853,175,9893,"NODAWAY","MO","Red"
29149,3847,823,69,4739,"OREGON","MO","Red"
29151,6425,1037,77,7539,"OSAGE","MO","Red"
29153,4064,752,48,4864,"OZARK","MO","Red"
29155,4120,1560,55,5735,"PEMISCOT","MO","Red"
29157,7657,1664,126,9447,"PERRY","MO","Red"
29159,13854,4783,460,19097,"PETTIS","MO","Red"
29161,13480,5637,451,19568,"PHELPS","MO","Red"
29163,5863,1717,115,7695,"PIKE","MO","Red"
29165,28917,27179,1174,57270,"PLATTE","MO","Red"
29167,11850,2885,329,15064,"POLK","MO","Red"
29169,10329,3740,345,14414,"PULASKI","MO","Red"
29171,1984,361,16,2361,"PUTNAM","MO","Red"
29173,4396,1205,61,5662,"RALLS","MO","Red"
29175,8018,2485,241,10744,"RANDOLPH","MO","Red"
29177,8345,3109,195,11649,"RAY","MO","Red"
29179,2733,529,36,3298,"REYNOLDS","MO","Red"
29181,4839,833,45,5717,"RIPLEY","MO","Red"
29183,128389,89530,4098,222017,"ST. CHARLES","MO","Red"
29185,3932,988,54,4974,"ST. CLAIR","MO","Red"
29186,6630,2713,141,9484,"STE. GENEVIEVE","MO","Red"
29187,20511,7044,446,28001,"ST. FRANCOIS","MO","Red"
29189,199493,328151,8802,536446,"ST. LOUIS COUNTY","MO","Blue"
29195,6451,2904,164,9519,"SALINE","MO","Red"
29197,1606,373,24,2003,"SCHUYLER","MO","Red"
29199,1560,388,36,1984,"SCOTLAND","MO","Red"
29201,13769,3753,197,17719,"SCOTT","MO","Red"
29203,3165,706,35,3906,"SHANNON","MO","Red"
29205,2700,592,58,3350,"SHELBY","MO","Red"
29207,11484,1819,123,13426,"STODDARD","MO","Red"
29209,14800,3506,177,18483,"STONE","MO","Red"
29211,1974,478,19,2471,"SULLIVAN","MO","Red"
29213,20508,5339,441,26288,"TANEY","MO","Red"
29215,9478,1716,121,11315,"TEXAS","MO","Red"
29217,7155,1903,127,9185,"VERNON","MO","Red"
29219,13222,4769,384,18375,"WARREN","MO","Red"
29221,8047,1804,125,9976,"WASHINGTON","MO","Red"
29223,4987,845,46,5878,"WAYNE","MO","Red"
29225,14880,3573,326,18779,"WEBSTER","MO","Red"
29227,877,215,15,1107,"WORTH","MO","Red"
29229,7453,1168,118,8739,"WRIGHT","MO","Red"
29510,21474,110089,2304,133867,"ST. LOUIS CITY","MO","Blue"
30001,3923,1608,130,5661,"BEAVERHEAD","MT","Red"
30003,2207,2491,86,4784,"BIG HORN","MT","Blue"
30005,1469,1589,59,3117,"BLAINE","MT","Blue"
30007,3173,835,89,4097,"BROADWATER","MT","Red"
30009,4468,2421,163,7052,"CARBON","MT","Red"
30011,775,74,15,864,"CARTER","MT","Red"
30013,23315,15456,1114,39885,"CASCADE","MT","Red"
30015,1891,991,83,2965,"CHOUTEAU","MT","Red"
30017,4205,1514,141,5860,"CUSTER","MT","Red"
30019,799,195,20,1014,"DANIELS","MT","Red"
30021,3758,962,105,4825,"DAWSON","MT","Red"
30023,2186,2562,143,4891,"DEER LODGE","MT","Blue"
30025,1375,172,28,1575,"FALLON","MT","Red"
30027,4869,1496,142,6507,"FERGUS","MT","Red"
30029,38321,20274,1341,59936,"FLATHEAD","MT","Red"
30031,31696,37044,2239,70979,"GALLATIN","MT","Blue"
30033,764,41,8,813,"GARFIELD","MT","Red"
30035,1884,3610,123,5617,"GLACIER","MT","Blue"
30037,414,78,11,503,"GOLDEN VALLEY","MT","Red"
30039,1419,638,45,2102,"GRANITE","MT","Red"
30041,3957,2981,244,7182,"HILL","MT","Red"
30043,5345,2625,181,8151,"JEFFERSON","MT","Red"
30045,1040,275,29,1344,"JUDITH BASIN","MT","Red"
30047,9322,6916,388,16626,"LAKE","MT","Red"
30049,21409,19743,1113,42265,"LEWIS AND CLARK","MT","Red"
30051,821,249,13,1083,"LIBERTY","MT","Red"
30053,8672,2835,240,11747,"LINCOLN","MT","Red"
30055,956,155,17,1128,"MCCONE","MT","Red"
30057,4191,1771,125,6087,"MADISON","MT","Red"
30059,833,258,19,1110,"MEAGHER","MT","Red"
30061,1828,686,49,2563,"MINERAL","MT","Red"
30063,26347,43357,1791,71495,"MISSOULA","MT","Blue"
30065,2423,413,45,2881,"MUSSELSHELL","MT","Red"
30067,6025,5280,261,11566,"PARK","MT","Red"
30069,298,39,11,348,"PETROLEUM","MT","Red"
30071,1936,416,30,2382,"PHILLIPS","MT","Red"
30073,2031,903,61,2995,"PONDERA","MT","Red"
30075,970,154,12,1136,"POWDER RIVER","MT","Red"
30077,2355,752,72,3179,"POWELL","MT","Red"
30079,603,126,15,744,"PRAIRIE","MT","Red"
30081,19114,8763,630,28507,"RAVALLI","MT","Red"
30083,4800,875,123,5798,"RICHLAND","MT","Red"
30085,1996,1910,111,4017,"ROOSEVELT","MT","Red"
30087,2486,1199,88,3773,"ROSEBUD","MT","Red"
30089,5660,1820,142,7622,"SANDERS","MT","Red"
30091,1403,574,53,2030,"SHERIDAN","MT","Red"
30093,7745,10392,521,18658,"SILVER BOW","MT","Blue"
30095,4462,1156,106,5724,"STILLWATER","MT","Red"
30097,1840,549,57,2446,"SWEET GRASS","MT","Red"
30099,2608,1007,64,3679,"TETON","MT","Red"
30101,1596,467,56,2119,"TOOLE","MT","Red"
30103,373,78,9,460,"TREASURE","MT","Red"
30105,3135,1030,96,4261,"VALLEY","MT","Red"
30107,823,225,20,1068,"WHEATLAND","MT","Red"
30109,516,77,5,598,"WIBAUX","MT","Red"
30111,50772,30679,2370,83821,"YELLOWSTONE","MT","Red"
31001,10085,4213,304,14602,"ADAMS","NE","Red"
31003,3093,452,38,3583,"ANTELOPE","NE","Red"
31005,260,21,3,284,"ARTHUR","NE","Red"
31007,362,43,5,410,"BANNER","NE","Red"
31009,280,35,2,317,"BLAINE","NE","Red"
31011,2653,499,65,3217,"BOONE","NE","Red"
31013,4002,1051,128,5181,"BOX BUTTE","NE","Red"
31015,1010,135,8,1153,"BOYD","NE","Red"
31017,1470,191,18,1679,"BROWN","NE","Red"
31019,16640,6350,599,23589,"BUFFALO","NE","Red"
31021,2580,1063,88,3731,"BURT","NE","Red"
31023,3542,873,83,4498,"BUTLER","NE","Red"
31025,10121,4737,426,15284,"CASS","NE","Red"
31027,4174,725,97,4996,"CEDAR","NE","Red"
31029,1740,226,27,1993,"CHASE","NE","Red"
31031,2844,373,48,3265,"CHERRY","NE","Red"
31033,3813,855,97,4765,"CHEYENNE","NE","Red"
31035,2848,632,78,3558,"CLAY","NE","Red"
31037,2636,1025,56,3717,"COLFAX","NE","Red"
31039,3507,870,74,4451,"CUMING","NE","Red"
31041,5090,786,117,5993,"CUSTER","NE","Red"
31043,3926,2744,124,6794,"DAKOTA","NE","Red"
31045,2931,1082,108,4121,"DAWES","NE","Red"
31047,6524,2497,157,9178,"DAWSON","NE","Red"
31049,871,141,20,1032,"DEUEL","NE","Red"
31051,2335,651,97,3083,"DIXON","NE","Red"
31053,10984,5544,348,16876,"DODGE","NE","Red"
31055,119159,150350,5442,274951,"DOUGLAS","NE","Blue"
31057,883,105,11,999,"DUNDY","NE","Red"
31059,2359,693,82,3134,"FILLMORE","NE","Red"
31061,1437,276,11,1724,"FRANKLIN","NE","Red"
31063,1229,189,22,1440,"FRONTIER","NE","Red"
31065,2163,399,39,2601,"FURNAS","NE","Red"
31067,7445,3385,238,11068,"GAGE","NE","Red"
31069,1016,161,18,1195,"GARDEN","NE","Red"
31071,933,133,9,1075,"GARFIELD","NE","Red"
31073,893,215,10,1118,"GOSPER","NE","Red"
31075,375,20,7,402,"GRANT","NE","Red"
31077,1016,229,13,1258,"GREELEY","NE","Red"
31079,16189,7681,504,24374,"HALL","NE","Red"
31081,4309,1118,106,5533,"HAMILTON","NE","Red"
31083,1615,282,31,1928,"HARLAN","NE","Red"
31085,494,34,6,534,"HAYES","NE","Red"
31087,1264,175,30,1469,"HITCHCOCK","NE","Red"
31089,4769,686,82,5537,"HOLT","NE","Red"
31091,376,59,7,442,"HOOKER","NE","Red"
31093,2786,648,67,3501,"HOWARD","NE","Red"
31095,2616,1016,84,3716,"JEFFERSON","NE","Red"
31097,1518,647,64,2229,"JOHNSON","NE","Red"
31099,2822,701,81,3604,"KEARNEY","NE","Red"
31101,3544,763,57,4364,"KEITH","NE","Red"
31103,476,49,4,529,"KEYA PAHA","NE","Red"
31105,1563,268,43,1874,"KIMBALL","NE","Red"
31107,3721,905,71,4697,"KNOX","NE","Red"
31109,70092,82293,3706,156091,"LANCASTER","NE","Blue"
31111,13071,3692,344,17107,"LINCOLN","NE","Red"
31113,407,38,5,450,"LOGAN","NE","Red"
31115,370,75,9,454,"LOUP","NE","Red"
31117,275,17,10,302,"MCPHERSON","NE","Red"
31119,11940,3478,347,15765,"MADISON","NE","Red"
31121,3419,743,95,4257,"MERRICK","NE","Red"
31123,2113,386,58,2557,"MORRILL","NE","Red"
31125,1437,359,32,1828,"NANCE","NE","Red"
31127,2428,921,74,3423,"NEMAHA","NE","Red"
31129,1857,409,37,2303,"NUCKOLLS","NE","Red"
31131,5649,2490,176,8315,"OTOE","NE","Red"
31133,1071,322,36,1429,"PAWNEE","NE","Red"
31135,1321,199,24,1544,"PERKINS","NE","Red"
31137,4157,752,100,5009,"PHELPS","NE","Red"
31139,3462,480,64,4006,"PIERCE","NE","Red"
31141,12186,3260,227,15673,"PLATTE","NE","Red"
31143,2291,530,58,2879,"POLK","NE","Red"
31145,4525,811,116,5452,"RED WILLOW","NE","Red"
31147,3073,996,57,4126,"RICHARDSON","NE","Red"
31149,744,84,13,841,"ROCK","NE","Red"
31151,3631,1986,153,5770,"SALINE","NE","Red"
31153,51979,41206,2488,95673,"SARPY","NE","Red"
31155,9108,3331,296,12735,"SAUNDERS","NE","Red"
31157,10952,4196,321,15469,"SCOTTS BLUFF","NE","Red"
31159,6490,2438,214,9142,"SEWARD","NE","Red"
31161,2292,340,40,2672,"SHERIDAN","NE","Red"
31163,1322,343,33,1698,"SHERMAN","NE","Red"
31165,642,72,15,729,"SIOUX","NE","Red"
31167,2561,532,68,3161,"STANTON","NE","Red"
31169,2308,624,48,2980,"THAYER","NE","Red"
31171,377,45,5,427,"THOMAS","NE","Red"
31173,1180,1122,23,2325,"THURSTON","NE","Red"
31175,1901,412,27,2340,"VALLEY","NE","Red"
31177,8583,3554,276,12413,"WASHINGTON","NE","Red"
31179,3055,1022,123,4200,"WAYNE","NE","Red"
31181,1511,335,30,1876,"WEBSTER","NE","Red"
31183,438,59,5,502,"WHEELER","NE","Red"
31185,5337,1630,176,7143,"YORK","NE","Red"
32001,9367,3048,466,12881,"CHURCHILL","NV","Red"
32003,430809,521777,19722,972308,"CLARK","NV","Blue"
32005,21623,11570,924,34117,"DOUGLAS","NV","Red"
32007,16734,4555,668,21957,"ELKO","NV","Red"
32009,395,72,13,480,"ESMERALDA","NV","Red"
32011,887,104,17,1008,"EUREKA","NV","Red"
32013,5877,1689,205,7771,"HUMBOLDT","NV","Red"
32015,2198,496,71,2765,"LANDER","NV","Red"
32017,2067,330,49,2446,"LINCOLN","NV","Red"
32019,20906,8472,851,30229,"LYON","NV","Red"
32021,1420,824,83,2327,"MINERAL","NV","Red"
32023,17527,7287,562,25376,"NYE","NV","Red"
32027,1731,547,42,2320,"PERSHING","NV","Red"
32029,1901,900,67,2868,"STOREY","NV","Red"
32031,116653,128052,7251,251956,"WASHOE","NV","Blue"
32033,3400,856,107,4363,"WHITE PINE","NV","Red"
32510,16113,12735,891,29739,"CARSON CITY","NV","Red"
33001,20899,16894,598,38391,"BELKNAP","NH","Red"
33003,16150,16649,422,33221,"CARROLL","NH","Blue"
33005,17898,25522,800,44220,"CHESHIRE","NH","Blue"
33007,8617,7640,258,16515,"COOS","NH","Red"
33009,19905,33180,881,53966,"GRAFTON","NH","Blue"
33011,104625,122344,3972,230941,"HILLSBOROUGH","NH","Blue"
33013,39711,48533,1561,89805,"MERRIMACK","NH","Blue"
33015,95858,100064,2876,198798,"ROCKINGHAM","NH","Blue"
33017,30489,41721,1386,73596,"STRAFFORD","NH","Blue"
33019,11508,12390,482,24380,"SULLIVAN","NH","Blue"
34001,64438,73808,1785,140031,"ATLANTIC","NJ","Blue"
34003,204417,285967,5465,495849,"BERGEN","NJ","Blue"
34005,103345,154595,3557,261497,"BURLINGTON","NJ","Blue"
34007,86207,175065,3344,264616,"CAMDEN","NJ","Blue"
34009,33158,23941,615,57714,"CAPE MAY","NJ","Red"
34011,28952,32742,714,62408,"CUMBERLAND","NJ","Blue"
34013,75475,266820,3016,345311,"ESSEX","NJ","Blue"
34015,83340,86702,2612,172654,"GLOUCESTER","NJ","Blue"
34017,65698,181452,2700,249850,"HUDSON","NJ","Blue"
34019,43153,39457,1632,84242,"HUNTERDON","NJ","Red"
34021,51641,122532,2431,176604,"MERCER","NJ","Blue"
34023,143467,226250,4645,374362,"MIDDLESEX","NJ","Blue"
34025,191808,181291,5052,378151,"MONMOUTH","NJ","Red"
34027,141134,153881,4307,299322,"MORRIS","NJ","Blue"
34029,217740,119456,4320,341516,"OCEAN","NJ","Red"
34031,92009,129097,2601,223707,"PASSAIC","NJ","Blue"
34033,18827,14479,616,33922,"SALEM","NJ","Red"
34035,71996,111173,2690,185859,"SOMERSET","NJ","Blue"
34037,51698,34481,1781,87960,"SUSSEX","NJ","Red"
34039,80002,170245,2744,252991,"UNION","NJ","Blue"
34041,34769,24901,1117,60787,"WARREN","NJ","Red"
35001,116135,193757,7698,317590,"BERNALILLO","NM","Blue"
35003,1698,595,33,2326,"CATRON","NM","Red"
35005,15656,6381,406,22443,"CHAVES","NM","Red"
35006,3975,4745,183,8903,"CIBOLA","NM","Blue"
35007,3271,2611,134,6016,"COLFAX","NM","Red"
35009,10444,4307,350,15101,"CURRY","NM","Red"
35011,656,231,14,901,"DE BACA","NM","Red"
35013,32802,47957,1882,82641,"DONA ANA","NM","Blue"
35015,17454,5424,344,23222,"EDDY","NM","Red"
35017,6553,7590,292,14435,"GRANT","NM","Blue"
35019,917,1234,38,2189,"GUADALUPE","NM","Blue"
35021,319,179,7,505,"HARDING","NM","Red"
35023,1120,823,31,1974,"HIDALGO","NM","Red"
35025,16531,4061,326,20918,"LEA","NM","Red"
35027,6942,3194,170,10306,"LINCOLN","NM","Red"
35028,4278,7554,461,12293,"LOS ALAMOS","NM","Blue"
35029,4408,3563,132,8103,"LUNA","NM","Red"
35031,7801,18029,656,26486,"MCKINLEY","NM","Blue"
35033,903,1745,38,2686,"MORA","NM","Blue"
35035,14521,8485,565,23571,"OTERO","NM","Red"
35037,2634,1170,69,3873,"QUAY","NM","Red"
35039,5408,10990,230,16628,"RIO ARRIBA","NM","Blue"
35041,4634,1802,172,6608,"ROOSEVELT","NM","Red"
35043,34174,40588,1800,76562,"SANDOVAL","NM","Blue"
35045,32874,18083,1337,52294,"SAN JUAN","NM","Red"
35047,3421,7888,222,11531,"SAN MIGUEL","NM","Blue"
35049,18329,62530,1368,82227,"SANTA FE","NM","Blue"
35051,3542,2265,138,5945,"SIERRA","NM","Red"
35053,3255,3722,183,7160,"SOCORRO","NM","Blue"
35055,3715,13121,345,17181,"TAOS","NM","Blue"
35057,4772,2344,165,7281,"TORRANCE","NM","Red"
35059,1388,383,18,1789,"UNION","NM","Red"
35061,17364,14263,650,32277,"VALENCIA","NM","Red"
36000,26393,107660,2592,136645,"KANSAS CITY","MO","Blue"
36001,51081,99474,4172,154727,"ALBANY","NY","Blue"
36003,14135,6048,712,20895,"ALLEGANY","NY","Red"
36005,67740,355374,9285,432399,"BRONX","NY","Blue"
36007,43800,47010,2684,93494,"BROOME","NY","Blue"
36009,22155,11879,984,35018,"CATTARAUGUS","NY","Red"
36011,19512,16149,1099,36760,"CAYUGA","NY","Red"
36013,34853,23087,1830,59770,"CHAUTAUQUA","NY","Red"
36015,21922,16636,1153,39711,"CHEMUNG","NY","Red"
36017,13482,8290,645,22417,"CHENANGO","NY","Red"
36019,16514,18364,759,35637,"CLINTON","NY","Blue"
36021,14464,20386,931,35781,"COLUMBIA","NY","Blue"
36023,10789,10369,734,21892,"CORTLAND","NY","Red"
36025,13387,9143,544,23074,"DELAWARE","NY","Red"
36027,66872,81443,3574,151889,"DUTCHESS","NY","Blue"
36029,197527,267174,12086,476787,"ERIE","NY","Blue"
36031,8976,9947,547,19470,"ESSEX","NY","Blue"
36033,9668,9253,499,19420,"FRANKLIN","NY","Red"
36035,15378,7931,763,24072,"FULTON","NY","Red"
36037,18876,9625,930,29431,"GENESEE","NY","Red"
36039,14271,10346,703,25320,"GREENE","NY","Red"
36041,2225,1178,86,3489,"HAMILTON","NY","Red"
36043,18870,9937,753,29560,"HERKIMER","NY","Red"
36045,25629,17307,1193,44129,"JEFFERSON","NY","Red"
36047,202772,703310,14298,920380,"KINGS","NY","Blue"
36049,8894,3824,318,13036,"LEWIS","NY","Red"
36051,18182,12477,997,31656,"LIVINGSTON","NY","Red"
36053,18408,14807,1051,34266,"MADISON","NY","Red"
36055,145661,225746,12092,383499,"MONROE","NY","Blue"
36057,12745,7977,524,21246,"MONTGOMERY","NY","Red"
36059,326716,396504,15149,738369,"NASSAU","NY","Blue"
36061,85185,603040,13180,701405,"NEW YORK","NY","Blue"
36063,56068,46029,2769,104866,"NIAGARA","NY","Red"
36065,57180,41567,2949,101696,"ONEIDA","NY","Red"
36067,90619,138894,6173,235686,"ONONDAGA","NY","Blue"
36069,29039,29025,2021,60085,"ONTARIO","NY","Red"
36071,84996,84684,3625,173305,"ORANGE","NY","Red"
36073,12126,5587,601,18314,"ORLEANS","NY","Red"
36075,32138,21143,1571,54852,"OSWEGO","NY","Red"
36077,14382,12975,866,28223,"OTSEGO","NY","Red"
36079,29283,24953,1082,55318,"PUTNAM","NY","Red"
36081,212665,569038,12795,794498,"QUEENS","NY","Blue"
36083,36500,40969,2493,79962,"RENSSELAER","NY","Blue"
36085,123320,90997,3582,217899,"RICHMOND","NY","Red"
36087,73186,75802,2393,151381,"ROCKLAND","NY","Blue"
36089,24608,19361,1298,45267,"ST. LAWRENCE","NY","Red"
36091,61305,68471,3780,133556,"SARATOGA","NY","Blue"
36093,30741,42465,2175,75381,"SCHENECTADY","NY","Blue"
36095,9903,5345,562,15810,"SCHOHARIE","NY","Red"
36097,5621,3903,275,9799,"SCHUYLER","NY","Red"
36099,8329,6914,475,15718,"SENECA","NY","Red"
36101,29474,15790,1252,46516,"STEUBEN","NY","Red"
36103,375821,368000,14056,757877,"SUFFOLK","NY","Red"
36105,18665,15489,978,35132,"SULLIVAN","NY","Red"
36107,14791,9634,745,25170,"TIOGA","NY","Red"
36109,11096,33619,1333,46048,"TOMPKINS","NY","Blue"
36111,37590,57970,2600,98160,"ULSTER","NY","Blue"
36113,17699,17642,1053,36394,"WARREN","NY","Red"
36115,15941,11565,750,28256,"WASHINGTON","NY","Red"
36117,26204,17456,1371,45031,"WAYNE","NY","Red"
36119,144713,312371,5181,462265,"WESTCHESTER","NY","Blue"
36121,13898,5073,512,19483,"WYOMING","NY","Red"
36123,6208,4219,361,10788,"YATES","NY","Red"
37001,46056,38825,1210,86091,"ALAMANCE","NC","Red"
37003,15888,4145,203,20236,"ALEXANDER","NC","Red"
37005,4527,1486,63,6076,"ALLEGHANY","NC","Red"
37007,5321,5789,84,11194,"ANSON","NC","Blue"
37009,11451,4164,199,15814,"ASHE","NC","Red"
37011,7172,2191,95,9458,"AVERY","NC","Red"
37013,16437,9633,245,26315,"BEAUFORT","NC","Red"
37015,3817,5939,59,9815,"BERTIE","NC","Blue"
37017,9676,7326,123,17125,"BLADEN","NC","Red"
37019,55850,33310,1015,90175,"BRUNSWICK","NC","Red"
37021,62412,96515,2642,161569,"BUNCOMBE","NC","Blue"
37023,31019,13118,465,44602,"BURKE","NC","Red"
37025,63237,52162,1828,117227,"CABARRUS","NC","Red"
37027,32119,10245,465,42829,"CALDWELL","NC","Red"
37029,4312,1537,104,5953,"CAMDEN","NC","Red"
37031,30028,12093,574,42695,"CARTERET","NC","Red"
37033,7089,4860,102,12051,"CASWELL","NC","Red"
37035,56588,25689,1148,83425,"CATAWBA","NC","Red"
37037,21186,26787,626,48599,"CHATHAM","NC","Blue"
37039,12628,3583,212,16423,"CHEROKEE","NC","Red"
37041,4471,3247,66,7784,"CHOWAN","NC","Red"
37043,5112,1699,82,6893,"CLAY","NC","Red"
37045,33798,16955,555,51308,"CLEVELAND","NC","Red"
37047,16832,9446,168,26446,"COLUMBUS","NC","Red"
37049,31032,21148,885,53065,"CRAVEN","NC","Red"
37051,60032,84469,2649,147150,"CUMBERLAND","NC","Blue"
37053,11657,4195,295,16147,"CURRITUCK","NC","Red"
37055,13938,9936,358,24232,"DARE","NC","Red"
37057,64658,22636,1220,88514,"DAVIDSON","NC","Red"
37059,18228,6713,370,25311,"DAVIE","NC","Red"
37061,13793,8767,155,22715,"DUPLIN","NC","Red"
37063,32459,144688,2767,179914,"DURHAM","NC","Blue"
37065,9206,16089,182,25477,"EDGECOMBE","NC","Blue"
37067,85064,113033,3173,201270,"FORSYTH","NC","Blue"
37069,20901,15879,571,37351,"FRANKLIN","NC","Red"
37071,73033,40959,1506,115498,"GASTON","NC","Red"
37073,3367,2546,58,5971,"GATES","NC","Red"
37075,3710,905,50,4665,"GRAHAM","NC","Red"
37077,16647,14565,386,31598,"GRANVILLE","NC","Red"
37079,4874,3832,47,8753,"GREENE","NC","Red"
37081,107294,173086,4106,284486,"GUILFORD","NC","Blue"
37083,10080,15545,134,25759,"HALIFAX","NC","Blue"
37085,35177,22093,1023,58293,"HARNETT","NC","Red"
37087,22834,13144,564,36542,"HAYWOOD","NC","Red"
37089,40032,27211,1128,68371,"HENDERSON","NC","Red"
37091,3479,7097,58,10634,"HERTFORD","NC","Blue"
37093,9453,11804,382,21639,"HOKE","NC","Blue"
37095,1418,1046,28,2492,"HYDE","NC","Red"
37097,67010,33888,1473,102371,"IREDELL","NC","Red"
37099,11356,9591,481,21428,"JACKSON","NC","Red"
37101,68353,41257,1747,111357,"JOHNSTON","NC","Red"
37103,3280,2197,48,5525,"JONES","NC","Red"
37105,16469,12143,396,29008,"LEE","NC","Red"
37107,14590,13605,214,28409,"LENOIR","NC","Red"
37109,36341,13274,602,50217,"LINCOLN","NC","Red"
37111,16883,5832,288,23003,"MCDOWELL","NC","Red"
37113,14211,6230,302,20743,"MACON","NC","Red"
37115,7979,4901,196,13076,"MADISON","NC","Red"
37117,6532,5911,97,12540,"MARTIN","NC","Red"
37119,179211,378107,9735,567053,"MECKLENBURG","NC","Blue"
37121,7090,1867,84,9041,"MITCHELL","NC","Red"
37123,8411,4327,111,12849,"MONTGOMERY","NC","Red"
37125,36764,20779,796,58339,"MOORE","NC","Red"
37127,25827,25947,497,52271,"NASH","NC","Blue"
37129,63331,66138,2361,131830,"NEW HANOVER","NC","Blue"
37131,3989,6069,52,10110,"NORTHAMPTON","NC","Blue"
37133,46078,24266,1891,72235,"ONSLOW","NC","Red"
37135,20176,63594,1227,84997,"ORANGE","NC","Blue"
37137,4849,2713,69,7631,"PAMLICO","NC","Red"
37139,9770,9832,295,19897,"PASQUOTANK","NC","Blue"
37141,21956,11723,490,34169,"PENDER","NC","Red"
37143,4903,2492,89,7484,"PERQUIMANS","NC","Red"
37145,13184,8465,245,21894,"PERSON","NC","Red"
37147,38982,47252,1339,87573,"PITT","NC","Blue"
37149,7689,4518,151,12358,"POLK","NC","Red"
37151,56894,15618,804,73316,"RANDOLPH","NC","Red"
37153,11830,8754,179,20763,"RICHMOND","NC","Red"
37155,27806,19020,362,47188,"ROBESON","NC","Red"
37157,31301,15992,516,47809,"ROCKINGHAM","NC","Red"
37159,49297,23114,997,73408,"ROWAN","NC","Red"
37161,24891,9135,403,34429,"RUTHERFORD","NC","Red"
37163,17411,10966,241,28618,"SAMPSON","NC","Red"
37165,7473,7186,116,14775,"SCOTLAND","NC","Red"
37167,25458,8129,352,33939,"STANLY","NC","Red"
37169,20142,5286,273,25701,"STOKES","NC","Red"
37171,27538,8721,379,36638,"SURRY","NC","Red"
37173,4161,2780,127,7068,"SWAIN","NC","Red"
37175,11636,8444,324,20404,"TRANSYLVANIA","NC","Red"
37177,1044,758,15,1817,"TYRRELL","NC","Red"
37179,80382,48725,1904,131011,"UNION","NC","Red"
37181,8391,12431,177,20999,"VANCE","NC","Blue"
37183,226197,393336,12297,631830,"WAKE","NC","Blue"
37185,3752,6400,141,10293,"WARREN","NC","Blue"
37187,2781,3396,28,6205,"WASHINGTON","NC","Blue"
37189,14451,17122,647,32220,"WATAUGA","NC","Blue"
37191,30709,24215,613,55537,"WAYNE","NC","Red"
37193,27592,7511,363,35466,"WILKES","NC","Red"
37195,19581,20754,400,40735,"WILSON","NC","Blue"
37197,15933,3763,227,19923,"YADKIN","NC","Red"
37199,7516,3688,148,11352,"YANCEY","NC","Red"
38001,981,258,30,1269,"ADAMS","ND","Red"
38003,3568,1820,177,5565,"BARNES","ND","Red"
38005,1094,822,45,1961,"BENSON","ND","Red"
38007,541,72,22,635,"BILLINGS","ND","Red"
38009,2575,821,75,3471,"BOTTINEAU","ND","Red"
38011,1395,228,34,1657,"BOWMAN","ND","Red"
38013,994,137,24,1155,"BURKE","ND","Red"
38015,34744,14348,1661,50753,"BURLEIGH","ND","Red"
38017,42619,40311,3123,86053,"CASS","ND","Red"
38019,1499,474,47,2020,"CAVALIER","ND","Red"
38021,1742,608,74,2424,"DICKEY","ND","Red"
38023,904,265,33,1202,"DIVIDE","ND","Red"
38025,1951,342,45,2338,"DUNN","ND","Red"
38027,854,383,24,1261,"EDDY","ND","Red"
38029,1738,237,34,2009,"EMMONS","ND","Red"
38031,1362,373,43,1778,"FOSTER","ND","Red"
38033,871,137,18,1026,"GOLDEN VALLEY","ND","Red"
38035,16987,12880,1103,30970,"GRAND FORKS","ND","Red"
38037,1145,207,29,1381,"GRANT","ND","Red"
38039,907,308,35,1250,"GRIGGS","ND","Red"
38041,1091,196,25,1312,"HETTINGER","ND","Red"
38043,1215,221,24,1460,"KIDDER","ND","Red"
38045,1645,527,47,2219,"LAMOURE","ND","Red"
38047,930,128,18,1076,"LOGAN","ND","Red"
38049,2364,564,75,3003,"MCHENRY","ND","Red"
38051,1153,261,41,1455,"MCINTOSH","ND","Red"
38053,4482,814,123,5419,"MCKENZIE","ND","Red"
38055,4198,1230,108,5536,"MCLEAN","ND","Red"
38057,3856,704,115,4675,"MERCER","ND","Red"
38059,12243,3872,504,16619,"MORTON","ND","Red"
38061,2824,1256,85,4165,"MOUNTRAIL","ND","Red"
38063,1141,586,50,1777,"NELSON","ND","Red"
38065,918,129,19,1066,"OLIVER","ND","Red"
38067,2460,786,85,3331,"PEMBINA","ND","Red"
38069,1585,497,46,2128,"PIERCE","ND","Red"
38071,3577,1639,156,5372,"RAMSEY","ND","Red"
38073,1418,945,91,2454,"RANSOM","ND","Red"
38075,1065,220,34,1319,"RENVILLE","ND","Red"
38077,5072,2510,230,7812,"RICHLAND","ND","Red"
38079,1257,2482,65,3804,"ROLETTE","ND","Blue"
38081,1266,738,66,2070,"SARGENT","ND","Red"
38083,688,104,20,812,"SHERIDAN","ND","Red"
38085,258,804,124,1186,"SIOUX","ND","Blue"
38087,380,44,3,427,"SLOPE","ND","Red"
38089,12110,2499,441,15050,"STARK","ND","Red"
38091,652,392,44,1088,"STEELE","ND","Red"
38093,6994,2676,289,9959,"STUTSMAN","ND","Red"
38095,830,317,27,1174,"TOWNER","ND","Red"
38097,2522,1493,121,4136,"TRAILL","ND","Red"
38099,3324,1333,126,4783,"WALSH","ND","Red"
38101,19974,7293,979,28246,"WARD","ND","Red"
38103,1893,442,39,2374,"WELLS","ND","Red"
38105,11739,2169,426,14334,"WILLIAMS","ND","Red"
39001,9870,2156,119,12145,"ADAMS","OH","Red"
39003,33116,14149,741,48006,"ALLEN","OH","Red"
39005,19407,6541,457,26405,"ASHLAND","OH","Red"
39007,26890,16497,760,44147,"ASHTABULA","OH","Red"
39009,10862,14772,425,26059,"ATHENS","OH","Blue"
39011,20798,4651,328,25777,"AUGLAIZE","OH","Red"
39013,23560,9138,390,33088,"BELMONT","OH","Red"
39015,16480,4380,236,21096,"BROWN","OH","Red"
39017,114392,69613,2732,186737,"BUTLER","OH","Red"
39019,10745,3251,216,14212,"CARROLL","OH","Red"
39021,14589,5062,321,19972,"CHAMPAIGN","OH","Red"
39023,39032,24076,1104,64212,"CLARK","OH","Red"
39025,74570,34092,1818,110480,"CLERMONT","OH","Red"
39027,15488,4697,342,20527,"CLINTON","OH","Red"
39029,35726,13359,775,49860,"COLUMBIANA","OH","Red"
39031,12325,4125,289,16739,"COSHOCTON","OH","Red"
39033,15436,4916,334,20686,"CRAWFORD","OH","Red"
39035,202699,416176,6795,625670,"CUYAHOGA","OH","Blue"
39037,22004,4731,399,27134,"DARKE","OH","Red"
39039,13038,5981,362,19381,"DEFIANCE","OH","Red"
39041,66356,57735,1979,126070,"DELAWARE","OH","Red"
39043,22160,17493,682,40335,"ERIE","OH","Red"
39045,50797,31224,1290,83311,"FAIRFIELD","OH","Red"
39047,9473,2975,164,12612,"FAYETTE","OH","Red"
39049,211237,409144,10196,630577,"FRANKLIN","OH","Blue"
39051,15731,6664,375,22770,"FULTON","OH","Red"
39053,10645,2990,164,13799,"GALLIA","OH","Red"
39055,34143,21201,677,56021,"GEAUGA","OH","Red"
39057,52072,34798,1773,88643,"GREENE","OH","Red"
39059,13407,4577,246,18230,"GUERNSEY","OH","Red"
39061,177886,246266,6777,430929,"HAMILTON","OH","Blue"
39063,26310,11757,704,38771,"HANCOCK","OH","Red"
39065,9949,3062,236,13247,"HARDIN","OH","Red"
39067,5792,1768,95,7655,"HARRISON","OH","Red"
39069,10479,4062,223,14764,"HENRY","OH","Red"
39071,15678,3799,199,19676,"HIGHLAND","OH","Red"
39073,9737,3880,207,13824,"HOCKING","OH","Red"
39075,10796,1994,157,12947,"HOLMES","OH","Red"
39077,18956,7759,475,27190,"HURON","OH","Red"
39079,11309,3311,174,14794,"JACKSON","OH","Red"
39081,22828,10018,516,33362,"JEFFERSON","OH","Red"
39083,22340,8589,469,31398,"KNOX","OH","Red"
39085,73278,55514,1717,130509,"LAKE","OH","Red"
39087,20306,7489,332,28127,"LAWRENCE","OH","Red"
39089,59514,33055,1641,94210,"LICKING","OH","Red"
39091,17964,5055,349,23368,"LOGAN","OH","Red"
39093,79520,75667,2250,157437,"LORAIN","OH","Red"
39095,81763,115411,3449,200623,"LUCAS","OH","Blue"
39097,13835,5698,322,19855,"MADISON","OH","Red"
39099,59903,57641,1422,118966,"MAHONING","OH","Red"
39101,19023,8269,526,27818,"MARION","OH","Red"
39103,64598,39800,1427,105825,"MEDINA","OH","Red"
39105,8316,2492,143,10951,"MEIGS","OH","Red"
39107,19452,4030,279,23761,"MERCER","OH","Red"
39109,41371,15663,938,57972,"MIAMI","OH","Red"
39111,5463,1605,80,7148,"MONROE","OH","Red"
39113,129034,135064,4407,268505,"MONTGOMERY","OH","Blue"
39115,5041,1725,81,6847,"MORGAN","OH","Red"
39117,14077,4048,332,18457,"MORROW","OH","Red"
39119,27867,11971,627,40465,"MUSKINGUM","OH","Red"
39121,5135,1170,38,6343,"NOBLE","OH","Red"
39123,14628,9008,371,24007,"OTTAWA","OH","Red"
39125,7086,2213,168,9467,"PAULDING","OH","Red"
39127,12357,4098,220,16675,"PERRY","OH","Red"
39129,20593,7304,374,28271,"PICKAWAY","OH","Red"
39131,9157,3110,145,12412,"PIKE","OH","Red"
39133,45990,35661,1221,82872,"PORTAGE","OH","Red"
39135,17022,4493,294,21809,"PREBLE","OH","Red"
39137,16412,3195,314,19921,"PUTNAM","OH","Red"
39139,41472,17640,863,59975,"RICHLAND","OH","Red"
39141,22278,10557,464,33299,"ROSS","OH","Red"
39143,18896,10596,582,30074,"SANDUSKY","OH","Red"
39145,22609,9080,358,32047,"SCIOTO","OH","Red"
39147,17086,8266,458,25810,"SENECA","OH","Red"
39149,20422,4465,371,25258,"SHELBY","OH","Red"
39151,111097,75904,2878,189879,"STARK","OH","Red"
39153,124833,151668,3972,280473,"SUMMIT","OH","Blue"
39155,55194,44519,1288,101001,"TRUMBULL","OH","Red"
39157,30458,12889,668,44015,"TUSCARAWAS","OH","Red"
39159,21669,11141,635,33445,"UNION","OH","Red"
39161,11650,3067,248,14965,"VAN WERT","OH","Red"
39163,4632,1331,67,6030,"VINTON","OH","Red"
39165,87988,46069,2043,136100,"WARREN","OH","Red"
39167,22307,9243,481,32031,"WASHINGTON","OH","Red"
39169,36759,16660,864,54283,"WAYNE","OH","Red"
39171,13452,4842,357,18651,"WILLIAMS","OH","Red"
39173,35757,30617,1223,67597,"WOOD","OH","Red"
39175,8462,2733,195,11390,"WYANDOT","OH","Red"
40001,5585,1387,136,7108,"ADAIR","OK","Red"
40003,1978,232,52,2262,"ALFALFA","OK","Red"
40005,4557,765,67,5389,"ATOKA","OK","Red"
40007,1968,190,20,2178,"BEAVER","OK","Red"
40009,6767,1048,133,7948,"BECKHAM","OK","Red"
40011,3136,688,77,3901,"BLAINE","OK","Red"
40013,12344,3323,309,15976,"BRYAN","OK","Red"
40015,7013,2670,176,9859,"CADDO","OK","Red"
40017,43550,16742,1648,61940,"CANADIAN","OK","Red"
40019,14699,4470,310,19479,"CARTER","OK","Red"
40021,11223,6027,464,17714,"CHEROKEE","OK","Red"
40023,4698,1082,52,5832,"CHOCTAW","OK","Red"
40025,970,70,14,1054,"CIMARRON","OK","Red"
40027,66677,49827,3274,119778,"CLEVELAND","OK","Red"
40029,2091,374,59,2524,"COAL","OK","Red"
40031,20905,13747,979,35631,"COMANCHE","OK","Red"
40033,2117,393,62,2572,"COTTON","OK","Red"
40035,4686,1217,129,6032,"CRAIG","OK","Red"
40037,23294,6577,634,30505,"CREEK","OK","Red"
40039,8060,2369,262,10691,"CUSTER","OK","Red"
40041,13557,3472,216,17245,"DELAWARE","OK","Red"
40043,2124,214,21,2359,"DEWEY","OK","Red"
40045,1688,162,23,1873,"ELLIS","OK","Red"
40047,16970,4919,541,22430,"GARFIELD","OK","Red"
40049,8878,1865,179,10922,"GARVIN","OK","Red"
40051,18538,4144,419,23101,"GRADY","OK","Red"
40053,1916,280,30,2226,"GRANT","OK","Red"
40055,1605,328,40,1973,"GREER","OK","Red"
40057,747,177,9,933,"HARMON","OK","Red"
40059,1327,136,24,1487,"HARPER","OK","Red"
40061,4165,783,66,5014,"HASKELL","OK","Red"
40063,3875,919,63,4857,"HUGHES","OK","Red"
40065,6392,1646,183,8221,"JACKSON","OK","Red"
40067,2026,319,40,2385,"JEFFERSON","OK","Red"
40069,3441,738,72,4251,"JOHNSTON","OK","Red"
40071,12834,4040,375,17249,"KAY","OK","Red"
40073,5521,854,90,6465,"KINGFISHER","OK","Red"
40075,2673,699,55,3427,"KIOWA","OK","Red"
40077,3437,762,50,4249,"LATIMER","OK","Red"
40079,15213,3299,293,18805,"LE FLORE","OK","Red"
40081,12013,2609,266,14888,"LINCOLN","OK","Red"
40083,15608,5455,511,21574,"LOGAN","OK","Red"
40085,3305,711,60,4076,"LOVE","OK","Red"
40087,15295,3582,359,19236,"MCCLAIN","OK","Red"
40089,9485,1858,124,11467,"MCCURTAIN","OK","Red"
40091,6172,2031,132,8335,"MCINTOSH","OK","Red"
40093,3084,320,63,3467,"MAJOR","OK","Red"
40095,4891,1100,73,6064,"MARSHALL","OK","Red"
40097,12749,3581,296,16626,"MAYES","OK","Red"
40099,4612,1156,126,5894,"MURRAY","OK","Red"
40101,16526,8027,528,25081,"MUSKOGEE","OK","Red"
40103,3821,1003,114,4938,"NOBLE","OK","Red"
40105,3610,712,69,4391,"NOWATA","OK","Red"
40107,3058,896,84,4038,"OKFUSKEE","OK","Red"
40109,145050,141724,7966,294740,"OKLAHOMA","OK","Red"
40111,9668,4357,288,14313,"OKMULGEE","OK","Red"
40113,14121,6002,415,20538,"OSAGE","OK","Red"
40115,8545,2686,207,11438,"OTTAWA","OK","Red"
40117,5267,1363,156,6786,"PAWNEE","OK","Red"
40119,17813,10904,926,29643,"PAYNE","OK","Red"
40121,13851,3768,305,17924,"PITTSBURG","OK","Red"
40123,10805,4117,398,15320,"PONTOTOC","OK","Red"
40125,20240,7275,670,28185,"POTTAWATOMIE","OK","Red"
40127,4016,668,55,4739,"PUSHMATAHA","OK","Red"
40129,1629,168,37,1834,"ROGER MILLS","OK","Red"
40131,34031,9589,933,44553,"ROGERS","OK","Red"
40133,6011,2150,176,8337,"SEMINOLE","OK","Red"
40135,12113,3035,238,15386,"SEQUOYAH","OK","Red"
40137,15560,3154,343,19057,"STEPHENS","OK","Red"
40139,4505,894,122,5521,"TEXAS","OK","Red"
40141,2076,597,35,2708,"TILLMAN","OK","Red"
40143,150574,108996,7108,266678,"TULSA","OK","Red"
40145,26165,8464,709,35338,"WAGONER","OK","Red"
40147,17076,5790,635,23501,"WASHINGTON","OK","Red"
40149,4086,598,93,4777,"WASHITA","OK","Red"
40151,2993,591,94,3678,"WOODS","OK","Red"
40153,6611,1005,169,7785,"WOODWARD","OK","Red"
41001,7352,2346,234,9932,"BAKER","OR","Red"
41003,14878,35827,2094,52799,"BENTON","OR","Blue"
41005,110509,139043,8127,257679,"CLACKAMAS","OR","Blue"
41007,10218,12916,776,23910,"CLATSOP","OR","Blue"
41009,17150,13835,1236,32221,"COLUMBIA","OR","Red"
41011,21829,14243,1003,37075,"COOS","OR","Red"
41013,11287,3801,360,15448,"CROOK","OR","Red"
41015,8484,6058,383,14925,"CURRY","OR","Red"
41017,55646,65962,3626,125234,"DESCHUTES","OR","Blue"
41019,43298,19160,1891,64349,"DOUGLAS","OR","Red"
41021,834,324,20,1178,"GILLIAM","OR","Red"
41023,3545,929,122,4596,"GRANT","OR","Red"
41025,3475,894,112,4481,"HARNEY","OR","Red"
41027,3955,8764,371,13090,"HOOD RIVER","OR","Blue"
41029,63869,59478,3818,127165,"JACKSON","OR","Red"
41031,7189,4393,331,11913,"JEFFERSON","OR","Red"
41033,31751,18451,1439,51641,"JOSEPHINE","OR","Red"
41035,25308,10388,1030,36726,"KLAMATH","OR","Red"
41037,3470,792,101,4363,"LAKE","OR","Red"
41039,80336,134366,7551,222253,"LANE","OR","Blue"
41041,12460,17385,881,30726,"LINCOLN","OR","Blue"
41043,43486,26512,2642,72640,"LINN","OR","Red"
41045,8187,3260,357,11804,"MALHEUR","OR","Red"
41047,79002,80872,5660,165534,"MARION","OR","Blue"
41049,3586,1371,161,5118,"MORROW","OR","Red"
41051,82995,367249,13415,463659,"MULTNOMAH","OR","Blue"
41053,23732,22917,1642,48291,"POLK","OR","Red"
41055,921,260,27,1208,"SHERMAN","OR","Red"
41057,8354,8066,468,16888,"TILLAMOOK","OR","Red"
41059,21270,10707,1061,33038,"UMATILLA","OR","Red"
41061,10298,4254,392,14944,"UNION","OR","Red"
41063,3404,1625,120,5149,"WALLOWA","OR","Red"
41065,7035,6604,491,14130,"WASCO","OR","Red"
41067,99073,209940,11313,320326,"WASHINGTON","OR","Blue"
41069,711,217,37,965,"WHEELER","OR","Red"
41071,29551,27174,2198,58923,"YAMHILL","OR","Red"
42001,37523,18207,810,56540,"ADAMS","PA","Red"
42003,282324,429065,8344,719733,"ALLEGHENY","PA","Blue"
42005,27489,8457,424,36370,"ARMSTRONG","PA","Red"
42007,54759,38122,1241,94122,"BEAVER","PA","Red"
42009,23025,4367,182,27574,"BEDFORD","PA","Red"
42011,109736,92895,2909,205540,"BERKS","PA","Red"
42013,45306,17636,653,63595,"BLAIR","PA","Red"
42015,21600,8046,513,30159,"BRADFORD","PA","Red"
42017,187367,204712,4155,396234,"BUCKS","PA","Blue"
42019,74359,37508,1438,113305,"BUTLER","PA","Red"
42021,48085,21730,759,70574,"CAMBRIA","PA","Red"
42023,1771,634,29,2434,"CAMERON","PA","Red"
42025,21984,11212,433,33629,"CARBON","PA","Red"
42027,36372,40055,1066,77493,"CENTRE","PA","Blue"
42029,128565,182372,3565,314502,"CHESTER","PA","Blue"
42031,14578,4678,237,19493,"CLARION","PA","Red"
42033,29203,9673,546,39422,"CLEARFIELD","PA","Red"
42035,11902,5502,221,17625,"CLINTON","PA","Red"
42037,20098,10532,541,31171,"COLUMBIA","PA","Red"
42039,28559,12924,521,42004,"CRAWFORD","PA","Red"
42041,77212,62245,2138,141595,"CUMBERLAND","PA","Red"
42043,66408,78983,1977,147368,"DAUPHIN","PA","Blue"
42045,118532,206423,2976,327931,"DELAWARE","PA","Blue"
42047,12140,4522,244,16906,"ELK","PA","Red"
42049,66869,68286,1928,137083,"ERIE","PA","Blue"
42051,41227,20444,468,62139,"FAYETTE","PA","Red"
42053,1882,728,36,2646,"FOREST","PA","Red"
42055,57245,22422,1116,80783,"FRANKLIN","PA","Red"
42057,6824,1085,68,7977,"FULTON","PA","Red"
42059,12579,4911,179,17669,"GREENE","PA","Red"
42061,17061,5445,286,22792,"HUNTINGDON","PA","Red"
42063,28089,12634,475,41198,"INDIANA","PA","Red"
42065,17960,4527,337,22824,"JEFFERSON","PA","Red"
42067,9649,2253,141,12043,"JUNIATA","PA","Red"
42069,52334,61991,1085,115410,"LACKAWANNA","PA","Blue"
42071,160209,115847,4183,280239,"LANCASTER","PA","Red"
42073,29597,15978,501,46076,"LAWRENCE","PA","Red"
42075,46731,23932,989,71652,"LEBANON","PA","Red"
42077,84259,98288,2166,184713,"LEHIGH","PA","Blue"
42079,86929,64873,1519,153321,"LUZERNE","PA","Red"
42081,41462,16971,821,59254,"LYCOMING","PA","Red"
42083,14083,5098,285,19466,"MCKEAN","PA","Red"
42085,36143,21067,744,57954,"MERCER","PA","Red"
42087,16670,4603,229,21502,"MIFFLIN","PA","Red"
42089,38726,44060,1043,83829,"MONROE","PA","Blue"
42091,185460,319511,5186,510157,"MONTGOMERY","PA","Blue"
42093,5844,3771,156,9771,"MONTOUR","PA","Red"
42095,83854,85087,2001,170942,"NORTHAMPTON","PA","Blue"
42097,28952,12677,654,42283,"NORTHUMBERLAND","PA","Red"
42099,18293,5950,409,24652,"PERRY","PA","Red"
42101,132740,603790,4847,741377,"PHILADELPHIA","PA","Blue"
42103,19213,13019,322,32554,"PIKE","PA","Red"
42105,7239,1726,99,9064,"POTTER","PA","Red"
42107,48871,20727,1005,70603,"SCHUYLKILL","PA","Red"
42109,13983,4910,247,19140,"SNYDER","PA","Red"
42111,31466,8654,423,40543,"SOMERSET","PA","Red"
42113,2619,921,55,3595,"SULLIVAN","PA","Red"
42115,15207,6236,309,21752,"SUSQUEHANNA","PA","Red"
42117,15742,4955,378,21075,"TIOGA","PA","Red"
42119,12356,7475,284,20115,"UNION","PA","Red"
42121,18569,7585,374,26528,"VENANGO","PA","Red"
42123,14237,6066,347,20650,"WARREN","PA","Red"
42125,72080,45088,1310,118478,"WASHINGTON","PA","Red"
42127,18637,9191,261,28089,"WAYNE","PA","Red"
42129,130218,72129,2350,204697,"WESTMORELAND","PA","Red"
42131,9936,4704,218,14858,"WYOMING","PA","Red"
42133,146733,88114,3624,238471,"YORK","PA","Red"
44001,9745,18050,620,28415,"BRISTOL","RI","Blue"
44003,42001,49113,1979,93093,"KENT","RI","Blue"
44005,15722,29486,940,46148,"NEWPORT","RI","Blue"
44007,102551,165012,5104,272667,"PROVIDENCE","RI","Blue"
44009,29818,44549,1693,76060,"WASHINGTON","RI","Blue"
45001,8215,4101,117,12433,"ABBEVILLE","SC","Red"
45003,51589,32275,1321,85185,"AIKEN","SC","Red"
45005,835,2718,40,3593,"ALLENDALE","SC","Blue"
45007,67565,27169,1359,96093,"ANDERSON","SC","Red"
45009,2417,4010,55,6482,"BAMBERG","SC","Blue"
45011,5492,4720,109,10321,"BARNWELL","SC","Red"
45013,53194,43419,1222,97835,"BEAUFORT","SC","Red"
45015,57397,45223,1838,104458,"BERKELEY","SC","Red"
45017,4305,3905,81,8291,"CALHOUN","SC","Red"
45019,93297,121485,4075,218857,"CHARLESTON","SC","Blue"
45021,18043,6983,244,25270,"CHEROKEE","SC","Red"
45023,8660,6941,156,15757,"CHESTER","SC","Red"
45025,11297,7431,148,18876,"CHESTERFIELD","SC","Red"
45027,8361,8250,122,16733,"CLARENDON","SC","Red"
45029,10440,8602,241,19283,"COLLETON","SC","Red"
45031,16832,15220,365,32417,"DARLINGTON","SC","Red"
45033,6582,6436,83,13101,"DILLON","SC","Red"
45035,41913,33824,1541,77278,"DORCHESTER","SC","Red"
45037,8184,4953,167,13304,"EDGEFIELD","SC","Red"
45039,4625,7382,129,12136,"FAIRFIELD","SC","Blue"
45041,32615,31153,742,64510,"FLORENCE","SC","Red"
45043,20487,15822,359,36668,"GEORGETOWN","SC","Red"
45045,150021,103030,5104,258155,"GREENVILLE","SC","Red"
45047,19431,12145,430,32006,"GREENWOOD","SC","Red"
45049,3906,5323,76,9305,"HAMPTON","SC","Blue"
45051,118821,59180,1743,179744,"HORRY","SC","Red"
45053,7078,7185,131,14394,"JASPER","SC","Blue"
45055,20471,12699,459,33629,"KERSHAW","SC","Red"
45057,30312,18937,619,49868,"LANCASTER","SC","Red"
45059,20004,10159,325,30488,"LAURENS","SC","Red"
45061,3008,5329,94,8431,"LEE","SC","Blue"
45063,92817,49301,2450,144568,"LEXINGTON","SC","Red"
45065,2958,2687,52,5697,"MCCORMICK","SC","Red"
45067,5711,8872,121,14704,"MARION","SC","Blue"
45069,5044,6290,112,11446,"MARLBORO","SC","Blue"
45071,11443,6958,230,18631,"NEWBERRY","SC","Red"
45073,29698,10414,556,40668,"OCONEE","SC","Red"
45075,13603,27295,307,41205,"ORANGEBURG","SC","Blue"
45077,42907,13645,994,57546,"PICKENS","SC","Red"
45079,58313,132570,2939,193822,"RICHLAND","SC","Blue"
45081,6210,2963,101,9274,"SALUDA","SC","Red"
45083,93560,52926,2169,148655,"SPARTANBURG","SC","Red"
45085,21000,27379,541,48920,"SUMTER","SC","Blue"
45087,8183,4935,139,13257,"UNION","SC","Red"
45089,5532,10289,164,15985,"WILLIAMSBURG","SC","Blue"
45091,82727,59008,2315,144050,"YORK","SC","Red"
46003,1052,317,36,1405,"AURORA","SD","Red"
46005,4808,2107,166,7081,"BEADLE","SD","Red"
46007,694,466,23,1183,"BENNETT","SD","Red"
46009,2235,721,45,3001,"BON HOMME","SD","Red"
46011,8000,6110,457,14567,"BROOKINGS","SD","Red"
46013,10580,6538,429,17547,"BROWN","SD","Red"
46015,1750,673,67,2490,"BRULE","SD","Red"
46017,183,352,14,549,"BUFFALO","SD","Blue"
46019,3731,939,132,4802,"BUTTE","SD","Red"
46021,747,117,9,873,"CAMPBELL","SD","Red"
46023,2552,1177,54,3783,"CHARLES MIX","SD","Red"
46025,1373,437,40,1850,"CLARK","SD","Red"
46027,2456,3083,159,5698,"CLAY","SD","Blue"
46029,8958,3837,366,13161,"CODINGTON","SD","Red"
46031,647,622,14,1283,"CORSON","SD","Red"
46033,3852,1522,120,5494,"CUSTER","SD","Red"
46035,5613,2648,193,8454,"DAVISON","SD","Red"
46037,1869,1052,43,2964,"DAY","SD","Red"
46039,1699,609,42,2350,"DEUEL","SD","Red"
46041,790,1131,45,1966,"DEWEY","SD","Blue"
46043,1468,216,23,1707,"DOUGLAS","SD","Red"
46045,1538,417,30,1985,"EDMUNDS","SD","Red"
46047,2878,1053,111,4042,"FALL RIVER","SD","Red"
46049,964,198,20,1182,"FAULK","SD","Red"
46051,2618,1056,71,3745,"GRANT","SD","Red"
46053,1771,455,32,2258,"GREGORY","SD","Red"
46055,1026,105,6,1137,"HAAKON","SD","Red"
46057,2372,647,64,3083,"HAMLIN","SD","Red"
46059,1433,373,30,1836,"HAND","SD","Red"
46061,1793,557,38,2388,"HANSON","SD","Red"
46063,748,49,16,813,"HARDING","SD","Red"
46065,5522,2953,248,8723,"HUGHES","SD","Red"
46067,2944,762,61,3767,"HUTCHINSON","SD","Red"
46069,564,136,10,710,"HYDE","SD","Red"
46071,738,359,18,1115,"JACKSON","SD","Red"
46073,721,270,15,1006,"JERAULD","SD","Red"
46075,498,90,11,599,"JONES","SD","Red"
46077,1904,819,56,2779,"KINGSBURY","SD","Red"
46079,3681,2068,124,5873,"LAKE","SD","Red"
46081,8753,4537,538,13828,"LAWRENCE","SD","Red"
46083,19617,11981,798,32396,"LINCOLN","SD","Red"
46085,1042,525,30,1597,"LYMAN","SD","Red"
46087,2068,769,63,2900,"MCCOOK","SD","Red"
46089,1075,222,27,1324,"MCPHERSON","SD","Red"
46091,1287,858,33,2178,"MARSHALL","SD","Red"
46093,9875,3285,510,13670,"MEADE","SD","Red"
46095,449,298,22,769,"MELLETTE","SD","Red"
46097,787,320,31,1138,"MINER","SD","Red"
46099,49249,40482,2595,92326,"MINNEHAHA","SD","Red"
46101,1951,1179,76,3206,"MOODY","SD","Red"
46103,35063,20606,1849,57518,"PENNINGTON","SD","Red"
46105,1401,239,29,1669,"PERKINS","SD","Red"
46107,1139,227,14,1380,"POTTER","SD","Red"
46109,2404,1828,75,4307,"ROBERTS","SD","Red"
46111,905,257,23,1185,"SANBORN","SD","Red"
46113,297,2829,74,3200,"OGLALA LAKOTA","SD","Blue"
46115,2104,998,61,3163,"SPINK","SD","Red"
46117,1203,421,28,1652,"STANLEY","SD","Red"
46119,726,185,19,930,"SULLY","SD","Red"
46121,532,1963,44,2539,"TODD","SD","Blue"
46123,2161,495,40,2696,"TRIPP","SD","Red"
46125,3290,1139,119,4548,"TURNER","SD","Red"
46127,5944,2725,186,8855,"UNION","SD","Red"
46129,1966,565,49,2580,"WALWORTH","SD","Red"
46135,6581,4016,303,10900,"YANKTON","SD","Red"
46137,404,481,21,906,"ZIEBACH","SD","Blue"
47001,23184,11741,645,35570,"ANDERSON","TN","Red"
47003,14354,4453,281,19088,"BEDFORD","TN","Red"
47005,5668,1529,63,7260,"BENTON","TN","Red"
47007,4725,971,62,5758,"BLEDSOE","TN","Red"
47009,47369,17932,1308,66609,"BLOUNT","TN","Red"
47011,35204,9851,810,45865,"BRADLEY","TN","Red"
47013,12331,2441,161,14933,"CAMPBELL","TN","Red"
47015,5190,1261,106,6557,"CANNON","TN","Red"
47017,9205,2559,141,11905,"CARROLL","TN","Red"
47019,19584,4529,379,24492,"CARTER","TN","Red"
47021,14438,5514,308,20260,"CHEATHAM","TN","Red"
47023,5952,1412,220,7584,"CHESTER","TN","Red"
47025,10604,2202,139,12945,"CLAIBORNE","TN","Red"
47027,2733,735,38,3506,"CLAY","TN","Red"
47029,12162,2533,164,14859,"COCKE","TN","Red"
47031,17883,5705,694,24282,"COFFEE","TN","Red"
47033,4673,1382,59,6114,"CROCKETT","TN","Red"
47035,25168,6728,383,32279,"CUMBERLAND","TN","Red"
47037,100218,199703,9737,309658,"DAVIDSON","TN","Blue"
47039,4229,904,108,5241,"DECATUR","TN","Red"
47041,6672,1750,91,8513,"DEKALB","TN","Red"
47043,17643,6106,574,24323,"DICKSON","TN","Red"
47045,11768,3158,153,15079,"DYER","TN","Red"
47047,15690,7027,267,22984,"FAYETTE","TN","Red"
47049,7441,1214,74,8729,"FENTRESS","TN","Red"
47051,13987,4864,281,19132,"FRANKLIN","TN","Red"
47053,16259,5771,305,22335,"GIBSON","TN","Red"
47055,9784,3298,121,13203,"GILES","TN","Red"
47057,8565,1467,102,10134,"GRAINGER","TN","Red"
47059,22259,5199,629,28087,"GREENE","TN","Red"
47061,4802,988,65,5855,"GRUNDY","TN","Red"
47063,18811,5500,320,24631,"HAMBLEN","TN","Red"
47065,92108,75522,3483,171113,"HAMILTON","TN","Red"
47067,2372,362,10,2744,"HANCOCK","TN","Red"
47069,5760,4180,123,10063,"HARDEMAN","TN","Red"
47071,9559,1775,204,11538,"HARDIN","TN","Red"
47073,20405,4083,336,24824,"HAWKINS","TN","Red"
47075,3343,4012,84,7439,"HAYWOOD","TN","Blue"
47077,9797,2092,131,12020,"HENDERSON","TN","Red"
47079,11239,3548,260,15047,"HENRY","TN","Red"
47081,7577,2130,125,9832,"HICKMAN","TN","Red"
47083,2718,871,97,3686,"HOUSTON","TN","Red"
47085,6120,2017,99,8236,"HUMPHREYS","TN","Red"
47087,4118,1135,70,5323,"JACKSON","TN","Red"
47089,18651,4654,311,23616,"JEFFERSON","TN","Red"
47091,6468,1246,87,7801,"JOHNSON","TN","Red"
47093,124540,91422,4594,220556,"KNOX","TN","Red"
47095,1492,526,16,2034,"LAKE","TN","Red"
47097,5674,3193,98,8965,"LAUDERDALE","TN","Red"
47099,15334,3195,189,18718,"LAWRENCE","TN","Red"
47101,4474,1072,63,5609,"LEWIS","TN","Red"
47103,12281,2919,408,15608,"LINCOLN","TN","Red"
47105,21713,6948,686,29347,"LOUDON","TN","Red"
47107,18198,4361,285,22844,"MCMINN","TN","Red"
47109,9093,1943,239,11275,"MCNAIRY","TN","Red"
47111,8096,1307,84,9487,"MACON","TN","Red"
47113,23943,18390,617,42950,"MADISON","TN","Red"
47115,9911,3177,168,13256,"MARION","TN","Red"
47117,11043,3605,230,14878,"MARSHALL","TN","Red"
47119,31464,14418,775,46657,"MAURY","TN","Red"
47121,4467,1008,57,5532,"MEIGS","TN","Red"
47123,16783,3764,250,20797,"MONROE","TN","Red"
47125,42187,32472,2099,76758,"MONTGOMERY","TN","Red"
47127,2888,573,78,3539,"MOORE","TN","Red"
47129,6930,1167,131,8228,"MORGAN","TN","Red"
47131,10790,2589,142,13521,"OBION","TN","Red"
47133,7918,2033,86,10037,"OVERTON","TN","Red"
47135,2775,615,38,3428,"PERRY","TN","Red"
47137,2381,525,25,2931,"PICKETT","TN","Red"
47139,6792,1492,76,8360,"POLK","TN","Red"
47141,23759,9185,649,33593,"PUTNAM","TN","Red"
47143,11050,2369,218,13637,"RHEA","TN","Red"
47145,19230,6043,644,25917,"ROANE","TN","Red"
47147,24536,8692,489,33717,"ROBERTSON","TN","Red"
47149,81480,59341,3057,143878,"RUTHERFORD","TN","Red"
47151,8004,986,62,9052,"SCOTT","TN","Red"
47153,5855,1298,99,7252,"SEQUATCHIE","TN","Red"
47155,33783,8721,1031,43535,"SEVIER","TN","Red"
47157,129815,246105,6135,382055,"SHELBY","TN","Blue"
47159,7136,1802,113,9051,"SMITH","TN","Red"
47161,4950,1232,114,6296,"STEWART","TN","Red"
47163,55860,17272,1225,74357,"SULLIVAN","TN","Red"
47165,63454,27680,1496,92630,"SUMNER","TN","Red"
47167,20070,6837,401,27308,"TIPTON","TN","Red"
47169,2936,1012,50,3998,"TROUSDALE","TN","Red"
47171,6599,1615,93,8307,"UNICOI","TN","Red"
47173,6803,1249,71,8123,"UNION","TN","Red"
47175,2342,544,35,2921,"VAN BUREN","TN","Red"
47177,11850,3924,235,16009,"WARREN","TN","Red"
47179,40444,18638,1121,60203,"WASHINGTON","TN","Red"
47181,5795,820,54,6669,"WAYNE","TN","Red"
47183,10396,3020,319,13735,"WEAKLEY","TN","Red"
47185,9606,2143,146,11895,"WHITE","TN","Red"
47187,86469,50161,2386,139016,"WILLIAMSON","TN","Red"
47189,50296,22254,1780,74330,"WILSON","TN","Red"
48001,15110,3955,162,19227,"ANDERSON","TX","Red"
48003,4943,850,70,5863,"ANDREWS","TX","Red"
48005,25076,9143,355,34574,"ANGELINA","TX","Red"
48007,9239,2916,135,12290,"ARANSAS","TX","Red"
48009,4300,446,50,4796,"ARCHER","TX","Red"
48011,1035,75,2,1112,"ARMSTRONG","TX","Red"
48013,12039,5876,203,18118,"ATASCOSA","TX","Red"
48015,11447,2951,156,14554,"AUSTIN","TX","Red"
48017,1434,409,17,1860,"BAILEY","TX","Red"
48019,10057,2505,153,12715,"BANDERA","TX","Red"
48021,20516,15474,675,36665,"BASTROP","TX","Red"
48023,1494,183,25,1702,"BAYLOR","TX","Red"
48025,6006,3288,126,9420,"BEE","TX","Red"
48027,67893,57014,2468,127375,"BELL","TX","Red"
48029,308618,448452,13748,770818,"BEXAR","TX","Blue"
48031,5443,1911,87,7441,"BLANCO","TX","Red"
48033,397,16,3,416,"BORDEN","TX","Red"
48035,7469,1561,96,9126,"BOSQUE","TX","Red"
48037,27116,10747,398,38261,"BOWIE","TX","Red"
48039,90433,62228,2323,154984,"BRAZORIA","TX","Red"
48041,47530,35349,2182,85061,"BRAZOS","TX","Red"
48043,2461,2258,103,4822,"BREWSTER","TX","Red"
48045,639,78,8,725,"BRISCOE","TX","Red"
48047,998,1470,16,2484,"BROOKS","TX","Blue"
48049,13698,2107,164,15969,"BROWN","TX","Red"
48051,6743,1788,78,8609,"BURLESON","TX","Red"
48053,18767,5639,311,24717,"BURNET","TX","Red"
48055,8031,6672,270,14973,"CALDWELL","TX","Red"
48057,5641,2148,67,7856,"CALHOUN","TX","Red"
48059,6012,734,86,6832,"CALLAHAN","TX","Red"
48061,49032,64063,1079,114174,"CAMERON","TX","Blue"
48063,3626,1394,40,5060,"CAMP","TX","Red"
48065,2779,297,46,3122,"CARSON","TX","Red"
48067,11033,2795,99,13927,"CASS","TX","Red"
48069,1602,466,15,2083,"CASTRO","TX","Red"
48071,17353,3997,302,21652,"CHAMBERS","TX","Red"
48073,15101,4210,197,19508,"CHEROKEE","TX","Red"
48075,1943,310,26,2279,"CHILDRESS","TX","Red"
48077,5069,614,61,5744,"CLAY","TX","Red"
48079,809,177,14,1000,"COCHRAN","TX","Red"
48081,1586,178,15,1779,"COKE","TX","Red"
48083,3641,451,32,4124,"COLEMAN","TX","Red"
48085,252318,230945,7593,490856,"COLLIN","TX","Red"
48087,1048,155,15,1218,"COLLINGSWORTH","TX","Red"
48089,7472,2420,83,9975,"COLORADO","TX","Red"
48091,62740,24826,1326,88892,"COMAL","TX","Red"
48093,5177,853,56,6086,"COMANCHE","TX","Red"
48095,1058,197,13,1268,"CONCHO","TX","Red"
48097,15596,3210,190,18996,"COOKE","TX","Red"
48099,15438,7565,490,23493,"CORYELL","TX","Red"
48101,540,113,9,662,"COTTLE","TX","Red"
48103,1247,241,15,1503,"CRANE","TX","Red"
48105,1220,344,10,1574,"CROCKETT","TX","Red"
48107,1396,527,30,1953,"CROSBY","TX","Red"
48109,415,438,11,864,"CULBERSON","TX","Blue"
48111,1389,197,23,1609,"DALLAM","TX","Red"
48113,307076,598576,13852,919504,"DALLAS","TX","Blue"
48115,2951,808,30,3789,"DAWSON","TX","Red"
48117,3294,1264,52,4610,"DEAF SMITH","TX","Red"
48119,2162,403,27,2592,"DELTA","TX","Red"
48121,222480,188695,6789,417964,"DENTON","TX","Red"
48123,6567,1494,57,8118,"DEWITT","TX","Red"
48125,853,130,5,988,"DICKENS","TX","Red"
48127,1384,2264,18,3666,"DIMMIT","TX","Blue"
48129,1438,198,12,1648,"DONLEY","TX","Red"
48131,2443,2575,35,5053,"DUVAL","TX","Blue"
48133,7237,983,73,8293,"EASTLAND","TX","Red"
48135,32697,11367,527,44591,"ECTOR","TX","Red"
48137,893,168,5,1066,"EDWARDS","TX","Red"
48139,56717,27565,1211,85493,"ELLIS","TX","Red"
48141,84331,178126,4272,266729,"EL PASO","TX","Blue"
48143,13684,2916,256,16856,"ERATH","TX","Red"
48145,4177,1899,57,6133,"FALLS","TX","Red"
48147,12171,2655,181,15007,"FANNIN","TX","Red"
48149,10171,2661,109,12941,"FAYETTE","TX","Red"
48151,1448,352,26,1826,"FISHER","TX","Red"
48153,1584,438,17,2039,"FLOYD","TX","Red"
48155,445,99,7,551,"FOARD","TX","Red"
48157,157718,195552,4244,357514,"FORT BEND","TX","Blue"
48159,4161,804,44,5009,"FRANKLIN","TX","Red"
48161,6991,1635,85,8711,"FREESTONE","TX","Red"
48163,2823,2422,34,5279,"FRIO","TX","Red"
48165,5355,576,65,5996,"GAINES","TX","Red"
48167,93911,58842,2307,155060,"GALVESTON","TX","Red"
48169,1413,231,9,1653,"GARZA","TX","Red"
48171,12514,3176,160,15850,"GILLESPIE","TX","Red"
48173,611,39,3,653,"GLASSCOCK","TX","Red"
48175,3085,877,33,3995,"GOLIAD","TX","Red"
48177,5627,1948,73,7648,"GONZALES","TX","Red"
48179,6840,829,113,7782,"GRAY","TX","Red"
48181,44163,14506,805,59474,"GRAYSON","TX","Red"
48183,32493,14796,693,47982,"GREGG","TX","Red"
48185,9432,2833,149,12414,"GRIMES","TX","Red"
48187,47553,28805,1261,77619,"GUADALUPE","TX","Red"
48189,7177,2279,130,9586,"HALE","TX","Red"
48191,995,168,6,1169,"HALL","TX","Red"
48193,3616,641,94,4351,"HAMILTON","TX","Red"
48195,1849,166,32,2047,"HANSFORD","TX","Red"
48197,1330,241,9,1580,"HARDEMAN","TX","Red"
48199,23858,3474,303,27635,"HARDIN","TX","Red"
48201,700630,918193,21995,1640818,"HARRIS","TX","Blue"
48203,21466,7908,343,29717,"HARRISON","TX","Red"
48205,1868,195,15,2078,"HARTLEY","TX","Red"
48207,1840,353,21,2214,"HASKELL","TX","Red"
48209,47680,59524,2191,109395,"HAYS","TX","Blue"
48211,1486,206,28,1720,"HEMPHILL","TX","Red"
48213,28911,7060,346,36317,"HENDERSON","TX","Red"
48215,90527,128199,2158,220884,"HIDALGO","TX","Blue"
48217,11926,2860,145,14931,"HILL","TX","Red"
48219,6536,1482,82,8100,"HOCKLEY","TX","Red"
48221,26496,5648,397,32541,"HOOD","TX","Red"
48223,12719,3046,176,15941,"HOPKINS","TX","Red"
48225,7060,2314,64,9438,"HOUSTON","TX","Red"
48227,8054,2069,118,10241,"HOWARD","TX","Red"
48229,779,371,15,1165,"HUDSPETH","TX","Red"
48231,29163,8906,528,38597,"HUNT","TX","Red"
48233,7681,965,127,8773,"HUTCHINSON","TX","Red"
48235,759,120,10,889,"IRION","TX","Red"
48237,3418,331,33,3782,"JACK","TX","Red"
48239,5231,1033,89,6353,"JACKSON","TX","Red"
48241,12542,2954,115,15611,"JASPER","TX","Red"
48243,784,501,20,1305,"JEFF DAVIS","TX","Red"
48245,47570,46073,1116,94759,"JEFFERSON","TX","Red"
48247,833,1197,6,2036,"JIM HOGG","TX","Blue"
48249,7453,6119,97,13669,"JIM WELLS","TX","Red"
48251,54628,16464,928,72020,"JOHNSON","TX","Red"
48253,5660,999,82,6741,"JONES","TX","Red"
48255,3968,1234,50,5252,"KARNES","TX","Red"
48257,37624,18405,689,56718,"KAUFMAN","TX","Red"
48259,20083,6020,349,26452,"KENDALL","TX","Red"
48261,127,65,2,194,"KENEDY","TX","Red"
48263,411,47,4,462,"KENT","TX","Red"
48265,20879,6524,342,27745,"KERR","TX","Red"
48267,1987,284,21,2292,"KIMBLE","TX","Red"
48269,151,8,0,159,"KING","TX","Red"
48271,1144,446,13,1603,"KINNEY","TX","Red"
48273,5504,5314,126,10944,"KLEBERG","TX","Red"
48275,1180,265,11,1456,"KNOX","TX","Red"
48277,16760,4458,224,21442,"LAMAR","TX","Red"
48279,3521,840,49,4410,"LAMB","TX","Red"
48281,8086,2144,169,10399,"LAMPASAS","TX","Red"
48283,1335,1052,19,2406,"LA SALLE","TX","Red"
48285,8804,1333,60,10197,"LAVACA","TX","Red"
48287,6255,1750,82,8087,"LEE","TX","Red"
48289,7523,1072,79,8674,"LEON","TX","Red"
48291,23302,5785,247,29334,"LIBERTY","TX","Red"
48293,6789,2213,93,9095,"LIMESTONE","TX","Red"
48295,1205,131,17,1353,"LIPSCOMB","TX","Red"
48297,4199,819,36,5054,"LIVE OAK","TX","Red"
48299,10079,2465,116,12660,"LLANO","TX","Red"
48301,60,4,2,66,"LOVING","TX","Red"
48303,78861,40017,1939,120817,"LUBBOCK","TX","Red"
48305,1853,428,12,2293,"LYNN","TX","Red"
48307,2904,490,42,3436,"MCCULLOCH","TX","Red"
48309,59543,36688,1641,97872,"MCLENNAN","TX","Red"
48311,460,53,3,516,"MCMULLEN","TX","Red"
48313,4169,1088,41,5298,"MADISON","TX","Red"
48315,3470,1339,55,4864,"MARION","TX","Red"
48317,1857,288,15,2160,"MARTIN","TX","Red"
48319,1991,457,26,2474,"MASON","TX","Red"
48321,9845,3733,149,13727,"MATAGORDA","TX","Red"
48323,6881,8332,133,15346,"MAVERICK","TX","Blue"
48325,15642,6773,242,22657,"MEDINA","TX","Red"
48327,823,197,8,1028,"MENARD","TX","Red"
48329,45624,12329,906,58859,"MIDLAND","TX","Red"
48331,7984,2496,98,10578,"MILAM","TX","Red"
48333,2217,271,17,2505,"MILLS","TX","Red"
48335,2170,397,12,2579,"MITCHELL","TX","Red"
48337,8615,1097,107,9819,"MONTAGUE","TX","Red"
48339,193382,74377,3784,271543,"MONTGOMERY","TX","Red"
48341,4359,1062,87,5508,"MOORE","TX","Red"
48343,3872,1669,46,5587,"MORRIS","TX","Red"
48345,604,46,2,652,"MOTLEY","TX","Red"
48347,17378,9000,407,26785,"NACOGDOCHES","TX","Red"
48349,13800,5101,222,19123,"NAVARRO","TX","Red"
48351,4882,1173,39,6094,"NEWTON","TX","Red"
48353,4131,1162,64,5357,"NOLAN","TX","Red"
48355,64617,60925,1780,127322,"NUECES","TX","Red"
48357,2812,302,42,3156,"OCHILTREE","TX","Red"
48359,917,81,11,1009,"OLDHAM","TX","Red"
48361,29186,6357,451,35994,"ORANGE","TX","Red"
48363,10179,2178,132,12489,"PALO PINTO","TX","Red"
48365,9326,2057,68,11451,"PANOLA","TX","Red"
48367,62045,13017,1066,76128,"PARKER","TX","Red"
48369,2135,488,27,2650,"PARMER","TX","Red"
48371,3215,1382,71,4668,"PECOS","TX","Red"
48373,18573,5387,226,24186,"POLK","TX","Red"
48375,22820,9921,596,33337,"POTTER","TX","Red"
48377,721,1463,33,2217,"PRESIDIO","TX","Blue"
48379,5155,842,56,6053,"RAINS","TX","Red"
48381,50796,12802,1076,64674,"RANDALL","TX","Red"
48383,942,172,10,1124,"REAGAN","TX","Red"
48385,1643,320,19,1982,"REAL","TX","Red"
48387,4517,1246,43,5806,"RED RIVER","TX","Red"
48389,2254,1395,40,3689,"REEVES","TX","Red"
48391,2210,1108,48,3366,"REFUGIO","TX","Red"
48393,529,17,4,550,"ROBERTS","TX","Red"
48395,5646,2374,79,8099,"ROBERTSON","TX","Red"
48397,36726,16412,753,53891,"ROCKWALL","TX","Red"
48399,3807,552,50,4409,"RUNNELS","TX","Red"
48401,16534,4629,214,21377,"RUSK","TX","Red"
48403,4784,669,38,5491,"SABINE","TX","Red"
48405,3007,980,15,4002,"SAN AUGUSTINE","TX","Red"
48407,10161,2337,142,12640,"SAN JACINTO","TX","Red"
48409,16516,8988,387,25891,"SAN PATRICIO","TX","Red"
48411,2308,287,7,2602,"SAN SABA","TX","Red"
48413,940,211,8,1159,"SCHLEICHER","TX","Red"
48415,4983,818,69,5870,"SCURRY","TX","Red"
48417,1484,130,14,1628,"SHACKELFORD","TX","Red"
48419,7975,2068,44,10087,"SHELBY","TX","Red"
48421,886,91,15,992,"SHERMAN","TX","Red"
48423,69080,29615,1394,100089,"SMITH","TX","Red"
48425,4105,768,74,4947,"SOMERVELL","TX","Red"
48427,8247,9123,155,17525,"STARR","TX","Blue"
48429,3385,397,18,3800,"STEPHENS","TX","Red"
48431,584,51,4,639,"STERLING","TX","Red"
48433,615,116,5,736,"STONEWALL","TX","Red"
48435,1222,322,13,1557,"SUTTON","TX","Red"
48437,1845,478,32,2355,"SWISHER","TX","Red"
48439,409741,411567,13389,834697,"TARRANT","TX","Blue"
48441,39547,14588,1000,55135,"TAYLOR","TX","Red"
48443,334,119,5,458,"TERRELL","TX","Red"
48445,2812,757,43,3612,"TERRY","TX","Red"
48447,806,82,6,894,"THROCKMORTON","TX","Red"
48449,7570,2856,115,10541,"TITUS","TX","Red"
48451,32313,12239,658,45210,"TOM GREEN","TX","Red"
48453,161337,435860,11378,608575,"TRAVIS","TX","Blue"
48455,5579,1323,36,6938,"TRINITY","TX","Red"
48457,8194,1403,63,9660,"TYLER","TX","Red"
48459,15809,2877,206,18892,"UPSHUR","TX","Red"
48461,1178,170,20,1368,"UPTON","TX","Red"
48463,6174,4073,97,10344,"UVALDE","TX","Red"
48465,8284,6771,225,15280,"VAL VERDE","TX","Red"
48467,22270,3516,243,26029,"VAN ZANDT","TX","Red"
48469,23358,10380,450,34188,"VICTORIA","TX","Red"
48471,15375,7884,353,23612,"WALKER","TX","Red"
48473,14260,8191,283,22734,"WALLER","TX","Red"
48475,3241,764,55,4060,"WARD","TX","Red"
48477,12959,4261,207,17427,"WASHINGTON","TX","Red"
48479,25898,41820,679,68397,"WEBB","TX","Blue"
48481,11926,4694,141,16761,"WHARTON","TX","Red"
48483,2159,168,10,2337,"WHEELER","TX","Red"
48485,32069,13161,810,46040,"WICHITA","TX","Red"
48487,3524,956,44,4524,"WILBARGER","TX","Red"
48489,2441,3108,0,5549,"WILLACY","TX","Blue"
48491,139729,143795,6031,289555,"WILLIAMSON","TX","Blue"
48493,18463,6350,200,25013,"WILSON","TX","Red"
48495,1753,358,15,2126,"WINKLER","TX","Red"
48497,27032,4973,360,32365,"WISE","TX","Red"
48499,19049,3509,221,22779,"WOOD","TX","Red"
48501,2174,420,37,2631,"YOAKUM","TX","Red"
48503,7110,1034,95,8239,"YOUNG","TX","Red"
48505,2033,1826,15,3874,"ZAPATA","TX","Red"
48507,1490,2864,25,4379,"ZAVALA","TX","Blue"
49001,2695,357,48,3100,"BEAVER","UT","Red"
49003,21548,4473,1002,27023,"BOX ELDER","UT","Red"
49005,38032,16650,3676,58358,"CACHE","UT","Red"
49007,6693,2392,284,9369,"CARBON","UT","Red"
49009,496,111,12,619,"DAGGETT","UT","Red"
49011,104135,57411,8268,169814,"DAVIS","UT","Red"
49013,7512,843,206,8561,"DUCHESNE","UT","Red"
49015,4207,572,119,4898,"EMERY","UT","Red"
49017,2158,514,60,2732,"GARFIELD","UT","Red"
49019,2248,2806,131,5185,"GRAND","UT","Blue"
49021,18989,4892,1223,25104,"IRON","UT","Red"
49023,5087,645,133,5865,"JUAB","UT","Red"
49025,2998,1083,99,4180,"KANE","UT","Red"
49027,5404,624,162,6190,"MILLARD","UT","Red"
49029,5181,1086,339,6606,"MORGAN","UT","Red"
49031,773,86,12,871,"PIUTE","UT","Red"
49033,1157,180,32,1369,"RICH","UT","Red"
49035,230174,289906,26501,546581,"SALT LAKE","UT","Blue"
49037,3535,3113,229,6877,"SAN JUAN","UT","Red"
49039,10459,1794,372,12625,"SANPETE","UT","Red"
49041,9052,1084,226,10362,"SEVIER","UT","Red"
49043,10252,15244,590,26086,"SUMMIT","UT","Blue"
49045,21014,8943,1549,31506,"TOOELE","UT","Red"
49047,13261,1663,379,15303,"UINTAH","UT","Red"
49049,192812,76033,15441,284286,"UTAH","UT","Red"
49051,10795,6187,808,17790,"WASATCH","UT","Red"
49053,67294,20530,3246,91070,"WASHINGTON","UT","Red"
49055,1229,365,27,1621,"WAYNE","UT","Red"
49057,65949,40695,4759,111403,"WEBER","UT","Red"
50001,6567,15089,955,22611,"ADDISON","VT","Blue"
50003,6724,11858,775,19357,"BENNINGTON","VT","Blue"
50005,5924,8529,705,15158,"CALEDONIA","VT","Blue"
50007,20104,72938,3713,96755,"CHITTENDEN","VT","Blue"
50009,2164,1890,183,4237,"ESSEX","VT","Red"
50011,11274,13612,1186,26072,"FRANKLIN","VT","Blue"
50013,2194,3346,242,5782,"GRAND ISLE","VT","Blue"
50015,4171,10773,735,15679,"LAMOILLE","VT","Blue"
50017,5782,8351,743,14876,"ORANGE","VT","Blue"
50019,7086,7757,599,15442,"ORLEANS","VT","Blue"
50021,14625,18746,1401,34772,"RUTLAND","VT","Blue"
50023,8707,25101,1517,35325,"WASHINGTON","VT","Blue"
50025,7251,20057,1144,28452,"WINDHAM","VT","Blue"
50027,10135,24779,1394,36308,"WINDSOR","VT","Blue"
51001,9172,7578,212,16962,"ACCOMACK","VA","Red"
51003,20804,42466,1387,64657,"ALBEMARLE","VA","Blue"
51005,5859,2243,101,8203,"ALLEGHANY","VA","Red"
51007,5390,2411,93,7894,"AMELIA","VA","Red"
51009,11041,5672,292,17005,"AMHERST","VA","Red"
51011,6702,2418,148,9268,"APPOMATTOX","VA","Red"
51013,22318,105344,3077,130739,"ARLINGTON","VA","Blue"
51015,30714,10840,724,42278,"AUGUSTA","VA","Red"
51017,1834,646,21,2501,"BATH","VA","Red"
51019,35600,12176,893,48669,"BEDFORD","VA","Red"
51021,2903,532,44,3479,"BLAND","VA","Red"
51023,15099,5700,324,21123,"BOTETOURT","VA","Red"
51025,3357,4552,39,7948,"BRUNSWICK","VA","Blue"
51027,8311,1587,59,9957,"BUCHANAN","VA","Red"
51029,4544,3471,114,8129,"BUCKINGHAM","VA","Red"
51031,21245,8070,586,29901,"CAMPBELL","VA","Red"
51033,8336,7657,295,16288,"CAROLINE","VA","Red"
51035,12659,2842,156,15657,"CARROLL","VA","Red"
51036,1761,2624,56,4441,"CHARLES CITY","VA","Blue"
51037,3815,2317,59,6191,"CHARLOTTE","VA","Red"
51041,93326,106935,3694,203955,"CHESTERFIELD","VA","Blue"
51043,5192,3920,225,9337,"CLARKE","VA","Red"
51045,2536,587,47,3170,"CRAIG","VA","Red"
51047,16012,10617,487,27116,"CULPEPER","VA","Red"
51049,3019,2227,67,5313,"CUMBERLAND","VA","Red"
51051,5748,1503,56,7307,"DICKENSON","VA","Red"
51053,8695,6224,173,15092,"DINWIDDIE","VA","Red"
51057,3075,3038,65,6178,"ESSEX","VA","Red"
51059,168401,419943,12899,601243,"FAIRFAX","VA","Blue"
51061,25106,17565,1000,43671,"FAUQUIER","VA","Red"
51063,6225,3004,183,9412,"FLOYD","VA","Red"
51065,8155,7414,277,15846,"FLUVANNA","VA","Red"
51067,20895,8381,428,29704,"FRANKLIN","VA","Red"
51069,30558,17207,953,48718,"FREDERICK","VA","Red"
51071,6876,2156,146,9178,"GILES","VA","Red"
51073,14875,6964,445,22284,"GLOUCESTER","VA","Red"
51075,9966,6685,301,16952,"GOOCHLAND","VA","Red"
51077,6529,1535,67,8131,"GRAYSON","VA","Red"
51079,6866,4163,284,11313,"GREENE","VA","Red"
51081,1914,2627,33,4574,"GREENSVILLE","VA","Blue"
51083,10418,7666,164,18248,"HALIFAX","VA","Red"
51085,44318,25307,1363,70988,"HANOVER","VA","Red"
51087,63440,116572,3287,183299,"HENRICO","VA","Blue"
51089,16725,9127,253,26105,"HENRY","VA","Red"
51091,1092,417,24,1533,"HIGHLAND","VA","Red"
51093,13707,9399,350,23456,"ISLE OF WIGHT","VA","Red"
51095,23153,25553,933,49639,"JAMES CITY","VA","Blue"
51097,2450,1590,75,4115,"KING AND QUEEN","VA","Red"
51099,8446,5404,377,14227,"KING GEORGE","VA","Red"
51101,7320,3260,157,10737,"KING WILLIAM","VA","Red"
51103,3697,3368,87,7152,"LANCASTER","VA","Red"
51105,8365,1489,93,9947,"LEE","VA","Red"
51107,82088,138372,4516,224976,"LOUDOUN","VA","Blue"
51109,13294,8269,353,21916,"LOUISA","VA","Red"
51111,3537,2418,47,6002,"LUNENBURG","VA","Red"
51113,5300,2698,135,8133,"MADISON","VA","Red"
51115,3901,1825,103,5829,"MATHEWS","VA","Red"
51117,9266,6803,138,16207,"MECKLENBURG","VA","Red"
51119,4196,2491,98,6785,"MIDDLESEX","VA","Red"
51121,20629,23218,1190,45037,"MONTGOMERY","VA","Blue"
51125,4812,4327,179,9318,"NELSON","VA","Red"
51127,9631,4621,219,14471,"NEW KENT","VA","Red"
51131,2955,3667,110,6732,"NORTHAMPTON","VA","Blue"
51133,4485,3252,78,7815,"NORTHUMBERLAND","VA","Red"
51135,4027,2971,80,7078,"NOTTOWAY","VA","Red"
51137,12426,7995,333,20754,"ORANGE","VA","Red"
51139,9345,3007,162,12514,"PAGE","VA","Red"
51141,7485,1954,96,9535,"PATRICK","VA","Red"
51143,23751,10115,361,34227,"PITTSYLVANIA","VA","Red"
51145,14055,5320,358,19733,"POWHATAN","VA","Red"
51147,4434,4973,168,9575,"PRINCE EDWARD","VA","Blue"
51149,10103,7103,233,17439,"PRINCE GEORGE","VA","Red"
51153,81222,142863,4182,228267,"PRINCE WILLIAM","VA","Blue"
51155,12127,4925,334,17386,"PULASKI","VA","Red"
51157,2812,2096,71,4979,"RAPPAHANNOCK","VA","Red"
51159,2547,1513,42,4102,"RICHMOND","VA","Red"
51161,34268,21801,1157,57226,"ROANOKE","VA","Red"
51163,8088,4086,203,12377,"ROCKBRIDGE","VA","Red"
51165,30349,12644,828,43821,"ROCKINGHAM","VA","Red"
51167,10879,2373,134,13386,"RUSSELL","VA","Red"
51169,9063,1692,114,10869,"SCOTT","VA","Red"
51171,16463,6836,385,23684,"SHENANDOAH","VA","Red"
51173,10963,3008,165,14136,"SMYTH","VA","Red"
51175,5730,3969,87,9786,"SOUTHAMPTON","VA","Red"
51177,39411,34307,1599,75317,"SPOTSYLVANIA","VA","Red"
51179,37636,40245,1748,79629,"STAFFORD","VA","Blue"
51181,2025,2397,49,4471,"SURRY","VA","Blue"
51183,2219,2827,42,5088,"SUSSEX","VA","Blue"
51185,16731,3205,216,20152,"TAZEWELL","VA","Red"
51187,14069,6603,475,21147,"WARREN","VA","Red"
51191,21679,6617,397,28693,"WASHINGTON","VA","Red"
51193,5318,4501,129,9948,"WESTMORELAND","VA","Red"
51195,13366,3110,139,16615,"WISE","VA","Red"
51197,11733,3143,197,15073,"WYTHE","VA","Red"
51199,20241,17683,867,38791,"YORK","VA","Red"
51510,14544,66240,1737,82521,"ALEXANDRIA CITY","VA","Blue"
51520,5347,2313,154,7814,"BRISTOL CITY","VA","Red"
51530,1863,825,88,2776,"BUENA VISTA CITY","VA","Red"
51540,3094,20696,423,24213,"CHARLOTTESVILLE CITY","VA","Blue"
51550,58180,66377,2689,127246,"CHESAPEAKE CITY","VA","Blue"
51570,6007,2972,181,9160,"COLONIAL HEIGHTS CITY","VA","Red"
51580,1580,964,59,2603,"COVINGTON CITY","VA","Red"
51590,7428,11710,318,19456,"DANVILLE CITY","VA","Blue"
51595,754,1612,18,2384,"EMPORIA CITY","VA","Blue"
51600,4007,9174,306,13487,"FAIRFAX CITY","VA","Blue"
51610,1490,7146,183,8819,"FALLS CHURCH CITY","VA","Blue"
51620,1487,2525,52,4064,"FRANKLIN CITY","VA","Blue"
51630,4037,8517,323,12877,"FREDERICKSBURG CITY","VA","Blue"
51640,1838,777,24,2639,"GALAX CITY","VA","Red"
51650,18430,46220,1307,65957,"HAMPTON CITY","VA","Blue"
51660,5591,11022,480,17093,"HARRISONBURG CITY","VA","Blue"
51670,4020,5430,178,9628,"HOPEWELL CITY","VA","Blue"
51678,906,1791,67,2764,"LEXINGTON CITY","VA","Blue"
51680,17097,18048,1219,36364,"LYNCHBURG CITY","VA","Blue"
51683,6256,10356,366,16978,"MANASSAS CITY","VA","Blue"
51685,1979,3992,117,6088,"MANASSAS PARK CITY","VA","Blue"
51690,2165,3766,93,6024,"MARTINSVILLE CITY","VA","Blue"
51700,26377,53099,1794,81270,"NEWPORT NEWS CITY","VA","Blue"
51710,23443,64440,2105,89988,"NORFOLK CITY","VA","Blue"
51720,1109,464,28,1601,"NORTON CITY","VA","Red"
51730,1584,12389,160,14133,"PETERSBURG CITY","VA","Blue"
51735,5605,2054,198,7857,"POQUOSON CITY","VA","Red"
51740,12755,30948,898,44601,"PORTSMOUTH CITY","VA","Blue"
51750,2786,3358,176,6320,"RADFORD CITY","VA","Blue"
51760,16603,92175,2403,111181,"RICHMOND CITY","VA","Blue"
51770,15607,26773,943,43323,"ROANOKE CITY","VA","Blue"
51775,7683,5148,220,13051,"SALEM CITY","VA","Red"
51790,5695,6981,316,12992,"STAUNTON CITY","VA","Blue"
51800,20082,28676,884,49642,"SUFFOLK CITY","VA","Blue"
51810,105087,117393,5237,227717,"VIRGINIA BEACH CITY","VA","Blue"
51820,5507,4961,249,10717,"WAYNESBORO CITY","VA","Red"
51830,1963,4790,137,6890,"WILLIAMSBURG CITY","VA","Blue"
51840,5221,6610,282,12113,"WINCHESTER CITY","VA","Blue"
53001,3907,1814,141,5862,"ADAMS","WA","Red"
53003,7319,4250,382,11951,"ASOTIN","WA","Red"
53005,60365,38706,3962,103033,"BENTON","WA","Red"
53007,22746,19349,1211,43306,"CHELAN","WA","Red"
53009,23062,24721,1481,49264,"CLALLAM","WA","Blue"
53011,126303,140324,8776,275403,"CLARK","WA","Blue"
53013,1754,668,73,2495,"COLUMBIA","WA","Red"
53015,34424,23938,1918,60280,"COWLITZ","WA","Red"
53017,12955,7811,542,21308,"DOUGLAS","WA","Red"
53019,2771,1486,110,4367,"FERRY","WA","Red"
53021,18039,13340,1025,32404,"FRANKLIN","WA","Red"
53023,1069,366,54,1489,"GARFIELD","WA","Red"
53025,24764,11819,1097,37680,"GRANT","WA","Red"
53027,19877,17354,1210,38441,"GRAYS HARBOR","WA","Red"
53029,22746,29213,1966,53925,"ISLAND","WA","Blue"
53031,6931,17204,657,24792,"JEFFERSON","WA","Blue"
53033,269167,907310,34030,1210507,"KING","WA","Blue"
53035,61563,90277,6832,158672,"KITSAP","WA","Blue"
53037,14105,11421,838,26364,"KITTITAS","WA","Red"
53039,7237,5959,364,13560,"KLICKITAT","WA","Red"
53041,29391,14520,1398,45309,"LEWIS","WA","Red"
53043,5150,1713,170,7033,"LINCOLN","WA","Red"
53045,18710,17269,1324,37303,"MASON","WA","Red"
53047,11840,8900,542,21282,"OKANOGAN","WA","Red"
53049,6953,6794,317,14064,"PACIFIC","WA","Red"
53051,5728,2593,232,8553,"PEND OREILLE","WA","Red"
53053,197730,249506,16845,464081,"PIERCE","WA","Blue"
53055,3057,9725,415,13197,"SAN JUAN","WA","Blue"
53057,32762,38252,2409,73423,"SKAGIT","WA","Blue"
53059,3885,3192,235,7312,"SKAMANIA","WA","Red"
53061,166428,256728,15640,438796,"SNOHOMISH","WA","Blue"
53063,148576,135765,11089,295430,"SPOKANE","WA","Red"
53065,19808,7839,783,28430,"STEVENS","WA","Red"
53067,65277,96608,6249,168134,"THURSTON","WA","Blue"
53069,1741,1165,75,2981,"WAHKIAKUM","WA","Red"
53071,16400,13690,1171,31261,"WALLA WALLA","WA","Red"
53073,50489,83660,4471,138620,"WHATCOM","WA","Blue"
53075,9067,11184,875,21126,"WHITMAN","WA","Blue"
53077,50555,43179,2459,96193,"YAKIMA","WA","Red"
54001,5116,1457,104,6677,"BARBOUR","WV","Red"
54003,33279,17186,1070,51535,"BERKELEY","WV","Red"
54005,6816,2041,155,9012,"BOONE","WV","Red"
54007,4120,1457,87,5664,"BRAXTON","WV","Red"
54009,7545,2947,164,10656,"BROOKE","WV","Red"
54011,21721,14994,645,37360,"CABELL","WV","Red"
54013,2364,568,39,2971,"CALHOUN","WV","Red"
54015,2679,641,45,3365,"CLAY","WV","Red"
54017,2619,435,47,3101,"DODDRIDGE","WV","Red"
54019,11580,5063,219,16862,"FAYETTE","WV","Red"
54021,2012,599,51,2662,"GILMER","WV","Red"
54023,4871,607,31,5509,"GRANT","WV","Red"
54025,10925,4655,270,15850,"GREENBRIER","WV","Red"
54027,8033,1939,114,10086,"HAMPSHIRE","WV","Red"
54029,9806,3790,204,13800,"HANCOCK","WV","Red"
54031,4859,1381,91,6331,"HARDY","WV","Red"
54033,20683,9215,567,30465,"HARRISON","WV","Red"
54035,10093,3207,208,13508,"JACKSON","WV","Red"
54037,15033,12127,543,27703,"JEFFERSON","WV","Red"
54039,46398,34344,1502,82244,"KANAWHA","WV","Red"
54041,5782,1538,137,7457,"LEWIS","WV","Red"
54043,6012,1711,107,7830,"LINCOLN","WV","Red"
54045,10534,2333,159,13026,"LOGAN","WV","Red"
54047,5148,1333,46,6527,"MCDOWELL","WV","Red"
54049,16300,8901,593,25794,"MARION","WV","Red"
54051,10435,3455,190,14080,"MARSHALL","WV","Red"
54053,8491,2526,186,11203,"MASON","WV","Red"
54055,19237,5556,341,25134,"MERCER","WV","Red"
54057,10040,2660,172,12872,"MINERAL","WV","Red"
54059,8544,1397,81,10022,"MINGO","WV","Red"
54061,20803,20282,987,42072,"MONONGALIA","WV","Red"
54063,5068,1345,77,6490,"MONROE","WV","Red"
54065,6537,1998,160,8695,"MORGAN","WV","Red"
54067,8279,2226,125,10630,"NICHOLAS","WV","Red"
54069,12354,7223,321,19898,"OHIO","WV","Red"
54071,2782,820,57,3659,"PENDLETON","WV","Red"
54073,2742,699,50,3491,"PLEASANTS","WV","Red"
54075,2895,1047,66,4008,"POCAHONTAS","WV","Red"
54077,11190,3163,219,14572,"PRESTON","WV","Red"
54079,20034,7878,589,28501,"PUTNAM","WV","Red"
54081,24673,7982,451,33106,"RALEIGH","WV","Red"
54083,8673,3362,165,12200,"RANDOLPH","WV","Red"
54085,3649,586,48,4283,"RITCHIE","WV","Red"
54087,4213,1455,95,5763,"ROANE","WV","Red"
54089,4074,1448,63,5585,"SUMMERS","WV","Red"
54091,5477,1796,110,7383,"TAYLOR","WV","Red"
54093,2841,938,65,3844,"TUCKER","WV","Red"
54095,3226,631,65,3922,"TYLER","WV","Red"
54097,7771,2256,194,10221,"UPSHUR","WV","Red"
54099,12585,4088,274,16947,"WAYNE","WV","Red"
54101,2759,610,33,3402,"WEBSTER","WV","Red"
54103,4993,1539,135,6667,"WETZEL","WV","Red"
54105,2134,466,53,2653,"WIRT","WV","Red"
54107,27202,10926,634,38762,"WOOD","WV","Red"
54109,7353,1157,82,8592,"WYOMING","WV","Red"
55001,7362,4329,127,11818,"ADAMS","WI","Red"
55003,3841,4801,115,8757,"ASHLAND","WI","Blue"
55005,15803,9194,349,25346,"BARRON","WI","Red"
55007,4617,6147,116,10880,"BAYFIELD","WI","Blue"
55009,75871,65511,2635,144017,"BROWN","WI","Red"
55011,4834,2860,122,7816,"BUFFALO","WI","Red"
55013,6462,3569,110,10141,"BURNETT","WI","Red"
55015,18156,12116,502,30774,"CALUMET","WI","Red"
55017,21317,13983,638,35938,"CHIPPEWA","WI","Red"
55019,10002,4524,372,14898,"CLARK","WI","Red"
55021,16927,16410,532,33869,"COLUMBIA","WI","Red"
55023,4620,3953,122,8695,"CRAWFORD","WI","Red"
55025,78800,260185,5806,344791,"DANE","WI","Blue"
55027,31355,16356,725,48436,"DODGE","WI","Red"
55029,9752,10044,321,20117,"DOOR","WI","Blue"
55031,10923,13218,536,24677,"DOUGLAS","WI","Blue"
55033,13173,9897,454,23524,"DUNN","WI","Red"
55035,25341,31620,1314,58275,"EAU CLAIRE","WI","Blue"
55037,2133,781,26,2940,"FLORENCE","WI","Red"
55039,35754,20588,909,57251,"FOND DU LAC","WI","Red"
55041,3285,1721,47,5053,"FOREST","WI","Red"
55043,14142,10998,468,25608,"GRANT","WI","Red"
55045,10169,10851,386,21406,"GREEN","WI","Blue"
55047,7168,3344,159,10671,"GREEN LAKE","WI","Red"
55049,5909,7828,255,13992,"IOWA","WI","Blue"
55051,2438,1533,39,4010,"IRON","WI","Red"
55053,5791,4256,137,10184,"JACKSON","WI","Red"
55055,27208,19904,867,47979,"JEFFERSON","WI","Red"
55057,8749,4746,214,13709,"JUNEAU","WI","Red"
55059,44972,42193,1573,88738,"KENOSHA","WI","Red"
55061,7927,3976,192,12095,"KEWAUNEE","WI","Red"
55063,28684,37846,1354,67884,"LA CROSSE","WI","Blue"
55065,4821,3647,87,8555,"LAFAYETTE","WI","Red"
55067,7330,3704,131,11165,"LANGLADE","WI","Red"
55069,10017,6261,219,16497,"LINCOLN","WI","Red"
55071,27218,16818,793,44829,"MANITOWOC","WI","Red"
55073,44624,30808,1319,76751,"MARATHON","WI","Red"
55075,15304,7366,309,22979,"MARINETTE","WI","Red"
55077,5719,3239,107,9065,"MARQUETTE","WI","Red"
55078,278,1303,9,1590,"MENOMINEE","WI","Blue"
55079,134357,317270,7344,458971,"MILWAUKEE","WI","Blue"
55081,13775,8433,403,22611,"MONROE","WI","Red"
55083,16226,6715,274,23215,"OCONTO","WI","Red"
55085,13671,10105,383,24159,"ONEIDA","WI","Red"
55087,58385,47667,1970,108022,"OUTAGAMIE","WI","Red"
55089,33912,26517,1057,61486,"OZAUKEE","WI","Red"
55091,2584,1489,71,4144,"PEPIN","WI","Red"
55093,12815,9796,706,23317,"PIERCE","WI","Red"
55095,16611,9370,390,26371,"POLK","WI","Red"
55097,19299,20428,876,40603,"PORTAGE","WI","Blue"
55099,5394,3032,120,8546,"PRICE","WI","Red"
55101,54479,50159,1813,106451,"RACINE","WI","Red"
55103,4871,3995,148,9014,"RICHLAND","WI","Red"
55105,37138,46658,1564,85360,"ROCK","WI","Blue"
55107,5257,2517,112,7886,"RUSK","WI","Red"
55109,32199,23190,1318,56707,"ST. CROIX","WI","Red"
55111,17493,18108,602,36203,"SAUK","WI","Blue"
55113,5909,4498,103,10510,"SAWYER","WI","Red"
55115,15173,7131,311,22615,"SHAWANO","WI","Red"
55117,37609,27101,1301,66011,"SHEBOYGAN","WI","Red"
55119,7657,2693,336,10686,"TAYLOR","WI","Red"
55121,8833,6285,262,15380,"TREMPEALEAU","WI","Red"
55123,8218,7457,248,15923,"VERNON","WI","Red"
55125,9261,5903,205,15369,"VILAS","WI","Red"
55127,33851,22789,960,57600,"WALWORTH","WI","Red"
55129,6334,3867,177,10378,"WASHBURN","WI","Red"
55131,60237,26650,1183,88070,"WASHINGTON","WI","Red"
55133,159649,103906,4441,267996,"WAUKESHA","WI","Red"
55135,18952,9703,475,29130,"WAUPACA","WI","Red"
55137,9016,4388,164,13568,"WAUSHARA","WI","Red"
55139,47796,44060,2176,94032,"WINNEBAGO","WI","Red"
55141,24308,16365,625,41298,"WOOD","WI","Red"
56001,8579,9092,1073,18744,"ALBANY","WY","Blue"
56003,4806,788,190,5784,"BIG HORN","WY","Red"
56005,16975,1935,825,19735,"CAMPBELL","WY","Red"
56007,5014,1427,265,6706,"CARBON","WY","Red"
56009,5917,861,232,7010,"CONVERSE","WY","Red"
56011,3651,378,114,4143,"CROOK","WY","Red"
56013,12007,5519,708,18234,"FREMONT","WY","Red"
56015,4878,1203,191,6272,"GOSHEN","WY","Red"
56017,1999,482,107,2588,"HOT SPRINGS","WY","Red"
56019,3881,897,174,4952,"JOHNSON","WY","Red"
56021,27891,15217,2129,45237,"LARAMIE","WY","Red"
56023,8643,1509,373,10525,"LINCOLN","WY","Red"
56025,25271,8530,1590,35391,"NATRONA","WY","Red"
56027,1118,155,49,1322,"NIOBRARA","WY","Red"
56029,12813,3410,592,16815,"PARK","WY","Red"
56031,3898,890,175,4963,"PLATTE","WY","Red"
56033,11843,4043,660,16546,"SHERIDAN","WY","Red"
56035,3957,882,161,5000,"SUBLETTE","WY","Red"
56037,12229,3823,646,16698,"SWEETWATER","WY","Red"
56039,4341,9848,598,14787,"TETON","WY","Blue"
56041,7496,1591,372,9459,"UINTA","WY","Red"
56043,3245,651,136,4032,"WASHAKIE","WY","Red"
56045,3107,360,93,3560,"WESTON","WY","Red"
